Die Zeit	Time
Der Man	Man
Die Hand	Hand
Der Tag	Day
Der Weg	Way
Das Auge	Eye
Das Ding	Thing
Der Kopf	Head
Das Jahr	Year
Die Raum	Room
Die Tür	Door
Die Frau	Woman
Das Gesicht	Face
Die Mutter	Mother
Das Volk	People
Die Nacht	Night
Das Haus	House
Der Vater	Father
Das Leben	Life
Der Rücken	Back
Die Stimme	Voice
Das Mädchen	Girl
Der Ort	Place
Der Junge	Boy
Das Auto	Car
Die Seite	Side
Der Arm	Arm
Das Kind	Child
Das Wort	Word
Der Moment	Moment
Das Haar	Hair
Der Fuß	Foot
Das Wasser	Water
Das Licht	Light
Die Welt	World
Der Name	Name
Der Freund	Friend
Das Fenster	Window
Der Körper	Body
Der Tisch	Table
Der Morgen	Morning
Das Bett	Bed
Die Mauer	Wall
Die Straße	Street
Die Schule	School
Die Luft	Air
Der Boden	Floor
Die Stunde	Hour
Das Ende	End
Die Familie	Family
Der Kerl	Guy
Die Art	Kind
Die Minute	Minute
Die Geschichte	Story
Der Gott	God
Die Woche	Week
Die Arbeit	Work
Die Schulter	Shoulder
Der Teil	Part
Der Geist	Mind
Das Buch	Book
Der Finger	Finger
Der Mund	Mouth
Das Kind	Kid
Das Glas	Glass
Der Baum	Tree
Der Klang	Sound
Die Linie	Line
Die Ehefrau	Wife
Das Herz	Heart
Das Geld	Money
Das Telefon	Phone
Das Aussehen	Look
Das Bein	Leg
Der Stuhl	Chair
Das Büro	Office
Der Bruder	Brother
Die Frage	Question
Die Stadt	City
Der Monat	Month
Das Baby	Baby
Das Zuhause	Home
Der Hund	Dog
Die Straße	Road
Die Idee	Idea
Die Küche	Kitchen
Das Los	Lot
Der Sohn	Son
Der Beruf	Job
Das Papier	Paper
Die Schwester	Sister
Das Lächeln	Smile
Der Punkt	Point
Der Gedanke	Thought
Die Liebe	Love
Die Stadt	Town
Der Tod	Death
Der Boden	Ground
Die Anderen	Others
Das Feuer	Fire
Der Schritt	Step
Das Blut	Blood
Die Tatsache	Fact
Der Atem	Breath
Die Lippe	Lip
Die Sonne	Sun
Gebäude	Building
Die Anzahl	Number
Der Ehemann	Husband
Das Elternteil	Parent
Die Ecke	Corner
Das Problem	Problem
Das Ehepaar	Couple
Die Tochter	Daughter
Der Beutel	Bag
Die Hölle	Hell
Die Rast	Rest
Das Geschäft	Business
Der Himmel	Sky
Die Kiste	Box
Die Person	Person
Der Grund	Reason
Das Recht	Right
Die Haut	Skin
Der Vater	Dad
Der Fall	Case
Das Stück	Piece
Der Doktor	Doctor
Die Ecke	Edge
Die Mama	Mom
Das Bild	Picture
Der Sinn	Sense
Das Ohr	Ear
Der Zweite	Second
Die Dame	Lady
Der Hals	Neck
Der Wind	Wind
Der Schreibtisch	Desk
Die Waffe	Gun
Der Stein	Stone
Der Kaffee	Coffee
Das Schiff	Ship
Die Erde	Earth
Das Essen	Food
Das Pferd	Horse
Das Feld	Field
Der Krieg	War
Der Nachmittag	Afternoon
Die Sir	Sir
Der Raum	Space
Der Abend	Evening
Der Brief	Letter
Die Bar	Bar
Der Traum	Dream
Die Wohnung	Apartment
Die Brust	Chest
Das Spiel	Game
Der Sommer	Summer
Der Grund	Matter
Die Stille	Silence
Die Spitze	Top
Der Fels	Rock
Die Macht	Power
Die Kleider	Clothes
Das Schild	Sign
Die Aufmerksamkeit	Attention
Die Musik	Music
Der Staat	State
Die Tasche	Pocket
Das Abendessen	Dinner
Die Halle	Hall
Der Schmerz	Pain
Das Alter	Age
Der Fluss	River
Die Chance	Chance
Die Nase	Nose
Der Schatten	Shadow
Die Polizei	Police
Das Gedächtnis	Memory
Die Farbe	Color
Das Knie	Knee
Das Holz	Wood
Das Hemd	Shirt
Die Party	Party
Das Land	Country
Der Lkw	Truck
Der Zahn	Tooth
Die Rechnung	Bill
Die Szene	Scene
Das Land	Land
Der Stern	Star
Der Vogel	Bird
Das Schlafzimmer	Bedroom
Der Onkel	Uncle
Die Art	Sort
Die Gruppe	Group
Die Wahrheit	Truth
Die Schwierigkeiten	Trouble
Die Menge	Crowd
Der Bahnhof	Station
Die Reiß	Tear
Die Klasse	Class
Das Meer	Sea
Das Tier	Animal
Das Zentrum	Center
Das Gefühl	Feeling
Das Geschäft	Store
Der Berg	Mountain
Die Nachrichten	News
Der Schuh	Shoe
Die Katze	Cat
Der Bildschirm	Screen
Die Flasche	Bottle
Der Anruf	Call
Die Lebenden	Living
Die Wange	Cheek
Der Schüler	Student
Der Ball	Ball
Die Sehenswürdigkeit	Sight
Der Hügel	Hill
Das Unternehmen	Company
Die Kirche	Church
Der Regen	Rain
Der Anzug	Suit
Der Eine	One
Die Richtung	Direction
Der Wille	Will
Der Hals	Throat
Die Mitte	Middle
Die Antwort	Answer
Das Zeug	Stuff
Das Krankenhaus	Hospital
Die Kamera	Camera
Das Kleid	Dress
Die Karte	Card
Der Hof	Yard
Die Dunkelheit	Dark
Die Scheiße	Shit
Das Bild	Image
Die Maschine	Machine
Die Distanz	Distance
Das Gebiet	Area
Der Erzähler	Narrator
Das Eis	Ice
Der Schnee	Snow
Die Notiz	Note
Der Spiegel	Mirror
Der König	King
Die Angst	Fear
Der Offizier	Officer
Das Loch	Hole
Der Schuss	Shot
Der Wächter	Guard
Die Unterhaltung	Conversation
Das Boot	Boat
Das System	System
Die Pflege	Care
Die Bit	Bit
Der Film	Movie
Der Knochen	Bone
Die Seite	Page
Der Kapitän	Captain
Die Tante	Aunt
Dunkelheit	Darkness
Die Kontrolle	Control
Das Getränk	Drink
Das Hotel	Hotel
Der Mantel	Coat
Die Treppen	Stair
Die Bestellung	Order
Die Rose	Rose
Der Fehl	Miss
Der Hut	Hat
Das Gold	Gold
Die Zigarette	Cigarette
Die Wolke	Cloud
Die Aussicht	View
Der Fahrer	Driver
Die Tasse	Cup
Die Figur	Figure
Der Ausdruck	Expression
Der Pfad	Path
Der Schlüssel	Key
Der Computer	Computer
Die Blume	Flower
Der Ring	Ring
Das Bad	Bathroom
Das Metall	Metal
Der Mond	Moon
Das Lied	Song
Der Soldat	Soldier
Das Radio	Radio
Die Geschichte	History
Die Welle	Wave
Der Plan	Plan
Das College	College
Der Fisch	Fish
Der Garten	Garden
Der Zug	Train
Das Geschäft	Shop
Der Polizist	Cop
Die Kunst	Art
Das Bier	Beer
Norden	North
Die Insel	Island
Der Bus	Bus
Der Geruch	Smell
Das Geräusch	Noise
Die Mama	Mama
Der Park	Park
Der Süden	South
Das Paar	Pair
Der Herr	Lord
Der Teller	Plate
Die Jacke	Jacket
Die Hilfe	Help
Der Papa	Daddy
Das Gras	Grass
Die Dank	Thanks
Die Hitze	Heat
Der Schlaf	Sleep
Das Gehirn	Brain
Der Service	Service
Die Reise	Trip
Der Beat	Beat
Das Messer	Knife
Der Platz	Spot
Die Nachricht	Message
Die Note	Mark
Der Lehrer	Teacher
Der Blick	Gaze
Das Dorf	Village
Der Winter	Winter
Die Front	Front
Das Gesetz	Law
Die Oberfläche	Surface
Die Bank	Bank
Das Team	Team
Das Maximum	Maximum
Die Position	Position
Der Bauch	Stomach
Die Wende	Turn
Der Westen	West
Das Mittagessen	Lunch
Der Wechsel	Change
Die Kreatur	Creature
Die Seele	Soul
Das Blatt	Leaf
Die Show	Show
Die Gate	Gate
Die Palme	Palm
Der Kunststoff	Plastic
Die Kraft	Force
Der Strand	Beach
Der Präsident	President
Die Form	Shape
Der Rauch	Smoke
Das Rad	Wheel
Das Silber	Silver
Das Dach	Roof
Das Gewicht	Weight
Die Zunge	Tongue
Der Tee	Tea
Die Strecke	Track
Der Winkel	Angle
Die Form	Form
Der Ton	Tone
Der Kreis	Circle
Der Frühling	Spring
Die Vorhalle	Porch
Das Blatt	Sheet
Das Mitglied	Member
Das Schwimmbecken	Pool
Das Bedürfnis	Need
Die Hoffnung	Hope
Der See	Lake
Die Brust	Breast
Die Überraschung	Surprise
Die Interesse	Interest
Der Boden	Bottom
Der Geist	Spirit
Der Block	Block
Die Sprache	Language
Die Brücke	Bridge
Staub	Dust
Die Zelle	Cell
Wein	Wine
Das Boot	Boot
Die Wahl	Choice
Die Reihe	Row
Das Gespräch	Talk
Das Flugzeug	Plane
Die Uhr	Watch
Die Information	Information
Die Großmutter	Grandmother
Der Flügel	Wing
Die Bob	Bob
Der Club	Club
Der Meister	Master
Die Gnade	Grace
Der Wald	Forest
Die Größe	Size
Der Satz	Set
Die Ehe	Marriage
Die Stirn	Forehead
Sturm	Storm
Die Türöffnung	Doorway
Die Situation	Situation
Der Zähler	Counter
Der Nachbar	Neighbor
Das Foto	Photo
Die Bühne	Stage
Das Treffen	Meeting
Die Krankenschwester	Nurse
Die Sicherheit	Security
Die Waffe	Weapon
Das Ereignis	Event
Die Decke	Ceiling
Der Motor	Engine
Das Geschenk	Gift
Das Restaurant	Restaurant
Die Tafel	Board
Der Flur	Hallway
Die Armee	Army
Der Aufwand	Effort
Der Osten	East
Der Agent	Agent
Die Zukunft	Future
Die Hose	Pant
Das Leder	Leather
Der Flug	Flight
Das Geschlecht	Sex
Das Gericht	Court
Der Kurs	Course
Der Dreck	Dirt
Das Ei	Egg
Das Kinn	Chin
Der Fremde	Stranger
Die Freude	Pleasure
Das Detail	Detail
Die Besatzung	Crew
Der Herbst	Fall
Der Gast	Guest
Das Erlebnis	Experience
Der Witz	Joke
Der Sand	Sand
Die Faust	Fist
Die Aktion	Action
Das Wandern	Walk
Die Hochzeit	Wedding
Der Deal	Deal
Die Natur	Nature
Der Planet	Planet
Der Cousin	Cousin
Die Bewegung	Movement
Das Fleisch	Flesh
Der Datensatz	Record
Das Camp	Camp
Die Zeitung	Newspaper
Der Strahl	Ray
Der Mensch	Human
Das Sofa	Couch
Die Bewegung	Motion
Der Großvater	Grandfather
Die Fotografie	Photograph
Das Geheimnis	Secret
Die Schönheit	Beauty
Das Vorhandensein	Presence
Die Glocke	Bell
Die Volks	Folk
Der Knopf	Button
Die Liste	List
Das Level	Level
Das Datum	Date
Das Thema	Subject
Der Unterschied	Difference
Die Pause	Pause
Der Van	Van
Die Klinge	Blade
Das Fernsehen	Television
Die Titelseite	Cover
Die Vergangenheit	Past
Der Bauernhof	Farm
Die Runden	Lap
Die Band	Band
Der Anwalt	Lawyer
Das Magazin	Magazine
Der Ast	Branch
Der Rahmen	Frame
Das Deck	Deck
Der Effekt	Effect
Der Tanz	Dance
Die Sicht	Vision
Das Gespenst	Ghost
Der Esel	Ass
Der Charakter	Character
Der Blick	Glance
Das Auf Wiedersehen	GoodBye
Das Park	Parking
Das Frühstück	Breakfast
Die Geste	Gesture
Das Glück	Luck
Die Decke	Blanket
Das Gas	Gas
Der Korridor	Corridor
Der Professor	Professor
Das Spiel	Play
Der Fehler	Mistake
Die Universität	University
Der Ozean	Ocean
Das Jahrhundert	Century
Der Honig	Honey
Der Stapel	Pile
Die Schale	Bowl
Basis	Base
Der Zaun	Fence
Die Regel	Rule
Das Gelächter	Laughter
Die Wut	Anger
Der Schweiß	Sweat
Der Unfall	Accident
Das Wetter	Weather
Die Entscheidung	Decision
Der Engel	Angel
Die Stärke	Strength
Das Huhn	Chicken
Die Studium	Study
Das Band	Tape
Das Handgelenk	Wrist
Der Halt	Stop
Die Hüfte	Hip
Die Regierung	Government
Der Bauch	Belly
Die Königin	Queen
Bericht	Report
Der Schweif	Tail
Die Pflanze	Plant
Die Flamme	Flame
Der Himmel	Heaven
Der Gürtel	Belt
Die Nachbarschaft	Neighborhood
Die Energie	Energy
Das Grün	Green
Das Viertel	Quarter
Der Feind	Enemy
Die Bewegung	Move
Der Eingang	Entrance
Die Bibliothek	Library
Der Verfasser	Writer
Der Frieden	Peace
Die Berührung	Touch
Der Topf	Pot
Der Typ	Type
Der Grund	Cause
Das Seil	Rope
Der Muskel	Muscle
Das Gemälde	Painting
Die Gardine	Curtain
Die Mahlzeit	Meal
Der Akt	Act
Der Wolf	Wolf
Die Kajüte	Cabin
Die Ladung	Charge
Die Uhr	Clock
Der Passagier	Passenger
Der Kumpel	Buddy
Das Medikament	Drug
Die Verwendung	Use
Die Bank	Bench
Der Verkehr	Traffic
Das Relief	Relief
Die Kappe	Cap
Das Rudel	Pack
Das Wochenende	Weekend
Der Stand	Stand
Der Aufzug	Elevator
Der Geburtstag	Birthday
Die Lilie	Lily
Das Bügeleisen	Iron
Das Fleisch	Meat
Die Augenbraue	Eyebrow
Die Antwort	Response
Die Geschwindigkeit	Speed
Die Absicht	Purpose
Der Rock	Skirt
Das Quadrat	Square
Die Fahrt	Drive
Den Artikel	Article
Das Englisch	English
Der Turm	Tower
Der Kampf	Battle
Der Film	Film
Das Rennen	Race
Der Schock	Shock
Die Sektion	Section
Die Methode	Manner
Das Schwert	Sword
Der Stock	Stick
Die Datei	File
Das Brot	Bread
Das Öl	Oil
Die Kette	Chain
Die Abteilung	Department
Projekt	Project
Der Mord	Murder
Der Bär	Bear
Der Test	Test
Der Besuch	Visit
Die Milch	Milk
Der Chef	Boss
Der Ellbogen	Elbow
Das Verlangen	Desire
Der Patient	Patient
Das Grinsen	Grin
Der Liebhaber	Lover
Der Preis	Price
Die Karte	Map
Das Wissen	Knowledge
Der Anfang	Beginning
Die Kälte	Cold
Der Schrank	Closet
Die Morgendämmerung	Dawn
Der Tempel	Temple
Der Spaß	Joy
Die Pflicht	Duty
Die Übung	Practice
Die Ferse	Heel
Das Tal	Valley
Der Kampf	Fight
Das Kabel	Wire
Die Jeans	Jeans
Der Kuss	Kiss
Der Kiefer	Jaw
Die Lauf	Run
Der Halt	Hold
Das Verhältnis	Relationship
Das Objekt	Object
Der Angriff	Attack
Das Gericht	Dish
Die Autobahn	Highway
Die Schattierung	Shade
Das Verbrechen	Crime
Das Weiß	White
Der Partner	Partner
Der Priester	Priest
Der Rasen	Lawn
Das Lachen	Laugh
Der Kofferraum	Trunk
Das Weinen	Cry
Das Programm	Program
Die Fahrt	Ride
Das Regal	Shelf
Der Gentleman	Gentleman
Das Sein	Being
Der Stahl	Steel
Der Bürgersteig	Sidewalk
Die Uniform	Uniform
Das Muster	Pattern
Der Beweis	Evidence
Der Spieler	Player
Der Roman	Novel
Das Kissen	Pillow
Die Lampe	Lamp
Die Schublade	Drawer
Die Gefahr	Danger
Der Detektiv	Detective
Die Instant	Instant
Das Denken	Thinking
Der Riss	Crack
Das Gebet	Prayer
Das Handtuch	Towel
Der Handschuh	Glove
Die Bucht	Bay
Das Publikum	Audience
Die Dose	Can
Die Bedingung	Condition
Der Pfad	Trail
Die Taille	Waist
Der Druck	Pressure
Das Telefon	Telephone
Das Waschbecken	Sink
Die Rückkehr	Return
Die Brise	Breeze
Der Geschmack	Taste
Der Fehler	Fault
Der Strom	Stream
Das Ergebnis	Result
Der Autor	Author
Das Trinkgeld	Tip
Die Dusche	Shower
Die Zehe	Toe
Die Jahreszeit	Season
Die Hälfte	Half
Der Dummkopf	Fool
Der Tunnel	Tunnel
Der Klient	Client
Die Garage	Garage
Die Mission	Mission
Der Chef	Chief
Die Kugel	Bullet
Der Markt	Market
Der Verlust	Loss
Die Reihe	Series
Der Stift	Pen
Der Begriff	Term
Das Gedicht	Poem
Der Prinz	Prince
Der Ton	Clay
Das Schloss	Lock
Die Realität	Reality
Die Schlange	Snake
Der Apfel	Apple
Die Maske	Mask
Dem Kunden	Customer
Die Geburt	Birth
Die Pause	Break
Das Wunder	Wonder
Das Sonnenlicht	Sunlight
Der Panzer	Tank
Das Personal	Staff
Die Lüge	Lie
Der Glaube	Faith
Die Ehre	Honor
Die Creme	Cream
Das Wohl	Sake
Das Opfer	Victim
Die Möglichkeit	Possibility
Der Kontakt	Contact
Die Stimmung	Mood
Der Daumen	Thumb
Das Lesen	Reading
Der Spaß	Fun
Die Kerze	Candle
Die Höhle	Cave
Die Post	Post
Das Gefängnis	Prison
Die Emotion	Emotion
Der Führer	Leader
Der Grad	Degree
Die Eigenschaft	Feature
Das Ticket	Ticket
Das Alien	Alien
Der Unterricht	Lesson
Die Wüste	Desert
Der Schnitt	Cut
Die Unordnung	Mess
Die Warnung	Warning
Das Märchen	Tale
Das Begräbnis	Funeral
Das Taxi	Cab
Der Reporter	Reporter
Das Geschenk	Present
Das Theater	Theater
Die Länge	Length
Der Schlamm	Mud
Die Wissenschaft	Science
Der Fall	Drop
Die Schnur	String
Die Rede	Speech
Die Kopie	Copy
Die Kuh	Cow
Der Arbeiter	Worker
Der Oberschenkel	Thigh
Das Labor	Lab
Die Rolle	Roll
Das Obst	Fruit
Der Patch	Patch
Die Seide	Silk
Der Buck	Buck
Die Ziegel	Brick
Das Gewehr	Rifle
Die Karriere	Career
Das Thema	Issue
Die Gelegenheit	Opportunity
Der Direktor	Director
Das Monster	Monster
Das Fahrzeug	Vehicle
Die Gasse	Alley
Die Hülse	Sleeve
Das Grab	Grave
Der Busch	Bush
Der Speisesaal	Dining
Die Eröffnung	Opening
Der Zwilling	Twin
Die Scheune	Barn
Das Pfund	Pound
Der Standort	Site
Der Blitz	Flash
Der Richter	Judge
Die Masse	Mass
Der Prozess	Process
Das Band	Tie
Der Geldbeutel	Purse
Das Rohr	Pipe
Der Drache	Dragon
Der Horizont	Horizon
Die Schale	Tray
Der Umschlag	Envelope
Die Prüfung	Check
Die Erwachsene	Adult
Der Notfall	Emergency
Das Material	Material
Die Kindheit	Childhood
Die Angewohnheit	Habit
Der Künstler	Artist
Die Adresse	Address
Der Duft	Scent
Das Universum	Universe
Das Kopfnicken	Nod
Die Muschel	Shell
Die Gemeinde	Community
Der Anfang	Start
Die Wunde	Wound
Die Maus	Mouse
Der Pilot	Pilot
Die Klasse	Grade
Das Video	Video
Der Korb	Basket
Der Wagen	Wagon
Der Versuch	Attempt
Das Sofa	Sofa
Der Kuchen	Cake
Der Kerl	Fellow
Die Affäre	Affair
Die Küste	Shore
Die Allgemeine	General
Der Ursprung	Root
Die Robe	Robe
Die Sorge	Concern
Die Presse	Press
Die Ratte	Rat
Die Gesellschaft	Society
Der Stil	Style
Die Kreis	County
Der Befehl	Command
Der Besucher	Visitor
Das Model	Model
Die Kammer	Chamber
Das Biest	Beast
Das Bündel	Bunch
Der Hintergrund	Background
Die Einheit	Unit
Die Möbel	Furniture
Der Nagel	Nail
Der Schrei	Scream
Die Eigenschaft	Property
Die Ausrüstung	Equipment
Die Auffahrt	Driveway
Der Griff	Grip
Das Rohr	Tube
Die Asche	Ash
Der Fan	Fan
Die Meinung	Opinion
Die Daten	Data
Die Verbindung	Connection
Der Trick	Trick
Das Mysterium	Mystery
Die Periode	Period
Das Schreiben	Writing
Der Horror	Horror
Die Süßigkeit	Candy
Die Bitch	Bitch
Die Gesundheit	Health
Der Geschäftsführer	Manager
Die Sicherheit	Safety
Die Höhe	Height
Die Erscheinung	Appearance
Der Seufzer	Sigh
Die Mine	Mine
Die Kleidung	Cloth
Die Reaktion	Reaction
Die Quelle	Source
Das Ich	Self
Die Pistole	Pistol
Der Flughafen	Airport
Der Held	Hero
Das Versprechen	Promise
Der Bogen	Bow
Das Zelt	Tent
Der Messestand	Booth
Das Geld	Cash
Die Straße	Avenue
Das TShirt	TShirt
Der Teppich	Carpet
Der Keller	Basement
Die Freundin	Girlfriend
Der Bart	Beard
Die Stirn	Brow
Der Bildschirm	Display
Das Signal	Signal
Der Diener	Servant
Das Flüstern	Whisper
Der Zweifel	Doubt
Das Konto	Account
Die Magie	Magic
Die Hank	Hank
Das Glied	Limb
Der Bastard	Bastard
Der Schädel	Skull
Der Satz	Sentence
Der Kragen	Collar
Das Horn	Horn
Die Eiche	Oak
Der Knöchel	Ankle
Die Puppe	Doll
Das Sandwich	Sandwich
Das Rotkehlchen	Robin
Die Justiz	Justice
Der Stolz	Pride
Die Jugend	Youth
Der Sekretär	Secretary
Die Forschung	Research
Der Sport	Sport
Die Aufgabe	Task
Der Zuschuss	Grant
Der Sheriff	Sheriff
Die Mitternachts	Midnight
Der Chip	Chip
Die Theorie	Theory
Den Wecker	Alarm
Die Sammlung	Collection
Das Kreuz	Cross
Die Kiefer	Pine
Die Generation	Generation
Die Autorität	Authority
Die Papa	Papa
Die Reise	Journey
Die Perle	Pearl
Die Toilette	Toilet
Der Mörder	Killer
Das Werkzeug	Tool
Die Medizin	Medicine
Der Zucker	Sugar
Die Prinzessin	Princess
Das Argument	Argument
Die Klippe	Cliff
Der Wagen	Cart
Der Kristall	Crystal
Die Bohne	Bean
Der Käfig	Cage
Die Schokolade	Chocolate
Die Küste	Coast
Das Jahrzehnt	Decade
Die Bedeutung	Meaning
Das Getriebe	Gear
Der Koffer	Suitcase
Die Operation	Operation
Das Atem	Breathing
Die Rolle	Role
Die Version	Version
Der Gefangene	Prisoner
Das Match	Match
Der Strahl	Beam
Die Burg	Castle
Der Ansturm	Rush
Die Fahrspur	Lane
Die Bekleidung	Clothing
Der Pol	Pole
Die Freiheit	Freedom
Das Können	Skill
Die Leidenschaft	Passion
Die Aktivität	Activity
Zum Teufel	Fuck
Die Platform	Platform
Das Salz	Salt
Das Fahrrad	Bike
Der Stapel	Stack
Der Begleiter	Companion
Das Schicksal	Fate
Die Wut	Rage
Die Versorgung	Supply
Der Wal	Whale
Das Schwein	Pig
Der Hase	Rabbit
Der Gang	Aisle
Der Bildschirm	Monitor
Der Helm	Helmet
Der Respekt	Respect
Die Aufregung	Excitement
Die Lobby	Lobby
Der Freund	Boyfriend
Das Fell	Fur
Der Bereich	Range
Die Dick	Dick
Der Code	Code
Das Kapitel	Chapter
Die Reflexion	Reflection
Die Post	Mail
Der Flug	Fly
Das Kabinett	Cabinet
Das Spielzeug	Toy
Die Baseball	Baseball
Das Innere	Inside
Die Geschwindigkeit	Pace
Der Griff	Handle
Die Führung	Lead
Die Summe	Amount
Der Nerv	Nerve
Der Schrecken	Terror
Der Pullover	Sweater
Die Qualität	Quality
Der Jäger	Hunter
Die Farbe	Paint
Die Buster	Buster
Die Baumwolle	Cotton
Der Wachtmeister	Sergeant
Der Kredit	Credit
Der Schlag	Blow
Der Teufel	Devil
Die Bedrohung	Threat
Der Erfolg	Success
Dem Vorabend	Eve
Das Kabel	Cable
Die Pfanne	Pan
Der Angestellte	Clerk
Den Titel	Title
Das Messgerät	Meter
Die Schande	Shame
Die Nadel	Needle
Die Lunge	Lung
Der Krieger	Warrior
Der Umstand	Circumstance
Das Studio	Studio
Die Panik	Panic
Der Mangel	Lack
Der Bauer	Farmer
Der Akzent	Accent
Die Bombe	Bomb
Die Platte	Panel
Die Fähigkeit	Ability
Das Glück	Fortune
Der Sieger	Victor
Die Feder	Feather
Die Oma	Grandma
Das Glühen	Glow
Das Verhalten	Behavior
Der Durchgang	Passage
Die Slave	Slave
Der Leutnant	Lieutenant
Der Lauf	Barrel
Die Wärme	Warmth
Der Eindruck	Impression
Der Maurer	Mason
Die Braut	Bride
Das Paket	Package
Der Nebel	Fog
Das Gehen	Walking
Die Balance	Balance
Die Socke	Sock
Der Roboter	Robot
Die Kartoffel	Potato
Der Gegenstand	Item
Das Bad	Bath
Der Diamant	Diamond
Die Leiche	Corpse
Die Erklärung	Explanation
Die Struktur	Structure
Der Ausgang	Exit
Das Pad	Pad
Der Herd	Stove
Das Blaue	Blue
Die Amerikaner	American
Der Rubin	Ruby
Der Blitz	Lightning
Die Grube	Pit
Der Oberst	Colonel
Das Dock	Dock
Der Bach	Creek
Der Ratschlag	Advice
Der Tourist	Tourist
Die Trauer	Grief
Die Verteidigung	Defense
Der Biss	Bite
Das Museum	Museum
Die Gunst	Favor
Das Abendessen	Supper
Der Komfort	Comfort
Der Dekan	Dean
Der Wert	Value
Der Marsch	March
Das Anwesen	Estate
Der Poet	Poet
Der Palast	Palace
Die Suppe	Soup
Die Nation	Nation
Das Gefäss	Jar
Der Ständige	Standing
Der Sack	Sack
Der Dämon	Demon
Die Konferenz	Conference
Der Saft	Juice
Die Verantwortung	Responsibility
Der Pinsel	Brush
Die Route	Route
Der Käse	Cheese
Die Haube	Hood
Die Ente	Duck
Der Heilige	Saint
Der Pass	Pass
Das Ziel	Target
Die Orange	Orange
Die Kultur	Culture
Die Reise	Tour
Der Kommandant	Commander
Der Haken	Hook
Der Nebel	Mist
Das Training	Training
Die Suche	Search
Die Münze	Coin
Das Wunder	Miracle
Der Vorteil	Advantage
Der Austausch	Exchange
Die Fiktion	Fiction
Der Teich	Pond
Der Assistent	Assistant
Das Design	Design
Die Angel	Fishing
Die Piste	Slope
Der Graf	Earl
Kommentar	Comment
Der Kellner	Waiter
Von Lebensmittel	Grocery
Die Leiter	Ladder
Die Kurve	Curve
Das Volumen	Volume
Das Risiko	Risk
Der Albtraum	Nightmare
Die Existenz	Existence
Die Spur	Trace
Die Krankheit	Disease
Die Unterstützung	Support
Der Zeuge	Witness
Die Aktie	Stock
Das Gerät	Device
Die Landschaft	Landscape
Der Urlaub	Holiday
Das Ass	Ace
Das Klavier	Piano
Die Eingeweide	Gut
Das Talent	Talent
Die Phantasie	Imagination
Die Schwarze	Black
Der Reed	Reed
Der Deckel	Lid
Der Hinweis	Hint
Der Wanderer	Walker
Die Kälte	Chill
Die Studie	Trial
Das Interview	Interview
Der Ansatz	Approach
Die Narbe	Scar
Die Mode	Fashion
Der Kanal	Channel
Die Tritt	Footstep
Der Aufnehmer	Pickup
Der Habicht	Hawk
Der Anhänger	Trailer
Die Statue	Statue
Die Pille	Pill
Der Käfer	Bug
Der Eimer	Bucket
Den Urlaub	Vacation
Die Arten	Species
Die Kolumne	Column
Der Schaden	Damage
Das Instrument	Instrument
Der Hafen	Port
Die Schicht	Layer
Der Streifen	Strip
Der Müll	Garbage
Die Rippe	Rib
Das Notebook	Notebook
Der Mais	Corn
Das Angebot	Offer
Die Zeichnung	Drawing
Die Aussage	Statement
Die Intelligenz	Intelligence
Die Entschuldigung	Excuse
Die Landung	Landing
Der Urheberrechts	Copyright
Die Stange	Rod
Die Fantasie	Fantasy
Die Neugier	Curiosity
Das Kleid	Gown
Die Grenze	Border
Die Poesie	Poetry
Die Firma	Firm
Der Aufgang	Rise
Die Handvoll	Handful
Die China	China
Die Franzosen	French
Die Durchschnitts	Mean
Das Reh	Deer
Die Druck	Print
Die Schiene	Rail
Die Rate	Rate
Der Mut	Courage
Die Ankunft	Arrival
Der Wunsch	Wish
Der Grat	Ridge
Der Idiot	Idiot
Der Bulle	Bull
Die Saat	Seed
Der Fortschritt	Progress
Das Gefühl	Feel
Die Shorts	Shorts
Der Bürger	Citizen
Der Müll	Trash
Das Protokoll	Log
Die Geduld	Patience
Die Fledermaus	Bat
Der Fußball	Football
Die Routine	Routine
Die Explosion	Explosion
Der Inhalt	Content
Der Wissenschaftler	Scientist
Das Versagen	Failure
Die Sünde	Sin
Der Hintern	Butt
Die Verwirrung	Confusion
Das Verständnis	Understanding
Der Handel	Trade
Der Kühlschrank	Refrigerator
Der Herr	Mister
Die Taschenlampe	Flashlight
Das Internet	Net
Der Seemann	Sailor
Die Attitüde	Attitude
Die Schuld	Guilt
Das Weinen	Crying
Die Sip	Sip
Die Reise	Travel
Der Keks	Cookie
Die Flucht	Escape
Die Anleitung	Instruction
Das Gewebe	Fabric
Der Marmor	Marble
Der Blick	Glimpse
Die Dämmerung	Dusk
Die Hütte	Cottage
Der Affe	Monkey
Das Makeup	Makeup
Die Doc	Doc
Die Bluse	Blouse
Der Rhythmus	Rhythm
Der Dampf	Steam
Der Satz	Phrase
Die Mutter	Nut
Der Bleistift	Pencil
Der Koch	Cook
Die Flagge	Flag
Der Trainer	Coach
Die Schaukel	Swing
Der Lautsprecher	Speaker
Der Bolzen	Bolt
Das Fett	Fat
Der Teppich	Rug
Die Klopf	Knock
Der Zauber	Spell
Das Taxi	Taxi
Die Runde	Round
Der Strohhalm	Straw
Die Luke	Hatch
Die Gabel	Fork
Das Böse	Evil
Das Dienstmädchen	Maid
Die Relative	Relative
Die Hexe	Witch
Der Hof	Courtyard
Die Sensation	Sensation
Die Blase	Bubble
Der Leser	Reader
Die Locke	Curl
Der Kuchen	Pie
Der Strahl	Jet
Die Verschiebung	Shift
Die Union	Union
Der Teenager	Teenager
Die Ebene	Plain
Die Kellnerin	Waitress
Die Antwort	Reply
Das Gerücht	Rumor
Die Schwerkraft	Gravity
Die Zuflucht	Shelter
Das Abenteuer	Adventure
Der Löwe	Lion
Die Wirbelsäule	Spine
Das Vertrauen	Confidence
Die Tiefe	Depth
Die Reichweite	Reach
Der Hammer	Hammer
Die Bibel	Bible
Der Vertrag	Contract
Der Geldbeutel	Wallet
Der Dschungel	Jungle
Die Fabrik	Factory
Die Indische	Indian
Der Balkon	Balcony
Der Reis	Rice
Der Knoten	Knot
Die Schnur	Cord
Der Kollege	Colleague
Die Absicht	Intention
Die Stare	Stare
Das Motel	Motel
Der Anwalt	Attorney
Der Liebling	Darling
Die Diskussion	Discussion
Atmosphäre	Atmosphere
Die Leistung	Performance
Die Spannung	Tension
Der Text	Text
Der Strang	Strand
Die Mittags	Noon
Die Vene	Vein
Der Experte	Expert
Die Gruppe	Gang
Der Polizist	Policeman
Der Krebs	Cancer
Der Fuchs	Fox
Die Scheidung	Divorce
Die Impuls	Pulse
Die Abwesenheit	Absence
Die Gewalt	Violence
Der Humor	Humor
Der Stuhl	Stool
Der Kies	Gravel
Der Schatz	Treasure
Die Butter	Butter
Der Schalter	Switch
Die Zigarre	Cigar
Die Leinwand	Canvas
Die Fröhlichkeit	Happiness
Der Führer	Guide
Der Stift	Pin
Der Schauspieler	Actor
Das Ganze	Whole
Die Vereinbarung	Arrangement
Die Braune	Brown
Der Gastgeber	Host
Das Farbband	Ribbon
Der Schal	Scarf
Die Skala	Scale
Der Beweis	Proof
Der Pfeil	Arrow
Die Temperatur	Temperature
Die Technologie	Technology
Die Erlaubnis	Permission
Der Ort	Location
Die Klaue	Claw
Der Cowboy	Cowboy
Die Agentur	Agency
Die Konstruktion	Construction
Das Jagd	Hunting
Das Gemüse	Vegetable
Die Dose	Tin
Der Hubschrauber	Helicopter
Die Falle	Trap
Das Pat	Pat
Die Lücke	Gap
Das Haustier	Pet
Die Bildung	Education
Das Einkaufen	Shopping
Der Schuppen	Shed
Die Vereinbarung	Agreement
Die Erde	Soil
Der Herzog	Duke
Die Schrotflinte	Shotgun
Die Vorstellung	Notion
Es Gibt	Rear
Die Zeremonie	Ceremony
Der Löffel	Spoon
Die Wanne	Tub
Der Schlüssel	Clue
Die Iris	Iris
Der Vorfall	Incident
Der Absturz	Crash
Das Tagebuch	Journal
Die Zugriffs	Access
Erz	Brass
Die Mama	Mommy
Die Seitenleiste	Sidebar
Das Schaf	Sheep
Der Ingenieur	Engineer
Der Rumpf	Hull
Der Geruch	Odor
Der Termin	Appointment
Die Einladung	Invitation
Die Lappen	Rag
Das Gute	Good
Der Kumpel	Dude
Die Behandlung	Treatment
Die Weisheit	Wisdom
Der Preis	Prize
Das Element	Element
Der Gigant	Giant
Die Serviette	Napkin
Die Wäsche	Laundry
Die Option	Option
Das Regal	Rack
Die Anforderung	Request
Das Gefängnis	Jail
Der Opa	Grandpa
Die Ranch	Ranch
Der Punkt	Dot
Das Skript	Script
Die Einkaufshalle	Mall
Der Ford	Ford
Die Übung	Exercise
Die Witwe	Widow
Die Krähe	Crow
Der Faden	Thread
Die Selbstmord	Suicide
Die Notiz	Notice
Der Sonnenuntergang	Sunset
Die Gallerie	Gallery
Das Schiff	Vessel
Der Donner	Thunder
Die Seife	Soap
Der Whisky	Whiskey
Das Weibchen	Female
Der Bürgermeister	Mayor
Der Hub	Stroke
Der Klick	Click
Der Ruf	Reputation
Der Müller	Miller
Der Rat	Council
Der Stundenplan	Schedule
Der Friedhof	Cemetery
Der Kampf	Struggle
Der Instinkt	Instinct
Die Ruhe	Calm
Der Arbeitnehmer	Employee
Das Nest	Nest
Das Limit	Limit
Der Deutsche	German
Der Mönch	Monk
Der Wurm	Worm
Das Dokument	Document
Die Traurigkeit	Sadness
Die Hütte	Hut
Die Lebensdauer	Lifetime
Die Tänzerin	Dancer
Die Versicherung	Insurance
Die Schwierigkeit	Difficulty
Die Matratze	Mattress
Der Mann	Male
Die Klinik	Clinic
Die Ad	Ad
Der Becher	Mug
Das Kit	Kit
Die Kommunikation	Communication
Das Unglück	Disaster
Die Fliese	Tile
Der Empfänger	Receiver
Das Gebrüll	Roar
Die Truppe	Troop
Der Sarg	Coffin
Die Freundschaft	Friendship
Die Ermittlung	Investigation
Der Verkauf	Sale
Das Ziel	Goal
Der Krankenwagen	Ambulance
Das Mondlicht	Moonlight
The Ward	Ward
Die Hosen	Trousers
Die Wolle	Wool
Die Mac	Mac
Der Minister	Minister
Der Eintritt	Entry
Der Dieb	Thief
Die Aktentasche	Briefcase
Das Mitleid	Pity
Die Finger	Fingertip
Die Marine	Navy
Das Insekt	Insect
The Velvet	Velvet
Die Biene	Bee
Der Stock	Cane
Das Gen	Gene
Der Salat	Salad
Die Windschutzscheibe	Windshield
Das Outfit	Outfit
Der Shuttle	Shuttle
Der Schrei	Shout
Die Wut	Fury
Die Herausforderung	Challenge
Die Zufriedenheit	Satisfaction
Der Motor	Motor
Das Produkt	Product
Das Unkraut	Weed
Die Strecke	Stretch
Das Fitnesscenter	Gym
Das Kapital	Capital
Der Rand	Rim
Die Pfote	Paw
Die Festung	Fort
Die Kosten	Cost
Das Plakat	Poster
Der Vampir	Vampire
Die Welle	Shaft
Die Identität	Identity
Der Bürgersteig	Pavement
Das Arschloch	Asshole
Der Gurt	Strap
Das Wohnzimmer	Parlor
Der Hafen	Harbor
Das Beispiel	Example
Das Netz	Web
Der Golf	Golf
Den Mist	Crap
Die Freude	Delight
Die Decke	Quilt
Die Steuer	Tax
Die Falte	Fold
Das Porträt	Portrait
Das Gewebe	Tissue
Der Glaube	Belief
Das Kostüm	Costume
Das Maß	Measure
Der Wagen	Carriage
Die Gitarre	Guitar
Der Ritter	Knight
Der Rang	Rank
Der Bürgermeister	Major
Der Brunnen	Fountain
Der Stall	Stall
Die Ladung	Load
Der Funke	Spark
Der Müll	Waste
Der Champagner	Champagne
Das Viertel	District
Der Schutz	Protection
Das Urteil	Judgment
Die Sympathie	Sympathy
Das Violett	Violet
Der Aufprall	Impact
Die Enttäuschung	Disappointment
Das Trink	Drinking
Das Bewusstsein	Consciousness
Das Taschentuch	Handkerchief
Das Tanzen	Dancing
Das Parfüm	Perfume
Das Netzwerk	Network
Der Anspruch	Claim
Die Nonne	Nun
Die Krone	Crown
Das Geländer	Railing
Die Lizenz	License
Die Barmherzigkeit	Mercy
Der Ballon	Balloon
Das Chaos	Chaos
Das Fieber	Fever
Das Schließfach	Locker
Die Sitzung	Session
Die Burst	Burst
Der Spitzer	Peak
Die Trommel	Drum
Der Fokus	Focus
Der Frosch	Frog
Der Vorteil	Benefit
Die Bemerkung	Remark
Die Gezeiten	Tide
Der Verdacht	Suspicion
Der Jeep	Jeep
Die Sorge	Worry
Die Literatur	Literature
Der Bogenschütze	Archer
Der Haushalt	Household
Das Pulver	Powder
Der Hirte	Shepherd
Die Linse	Lens
Der Favorit	Favorite
Die Madame	Madame
Die Villa	Mansion
Der Boom	Boom
Die Spitze	Lace
Die Überprüfung	Review
Die Rezeption	Reception
Der Schrott	Scrap
Der Wulst	Bead
Die Blendung	Glare
Die Strömung	Flow
Das Cafe	Cafe
Der Status	Status
Das Pochen	Pounding
Die Rakete	Rocket
Die Schlucht	Canyon
Die Trauer	Sorrow
Die Spinne	Spider
Die Explosion	Blast
Die Persönlichkeit	Personality
Der Campus	Campus
Der Fluch	Curse
Das Treppenhaus	Staircase
Der Drang	Urge
Die Frustration	Frustration
Die Pumpe	Pump
Die Leichtigkeit	Ease
Die Zählung	Count
Die Lösung	Solution
Der Schmuck	Jewelry
Die Sirene	Siren
Der Schlag	Hit
Die Tradition	Tradition
Das Leer	Curb
Die Vielfalt	Variety
Der Pirat	Pirate
Die Beschreibung	Description
Der Liebe	Dear
Die Angst	Anxiety
Die Tonhöhe	Pitch
Die Pizza	Pizza
Der Elefant	Elephant
Die Politik	Politics
Der Tennis	Tennis
Der Hunger	Hunger
Das Genie	Genius
Die Ziege	Goat
Der Sieg	Victory
Die Kombination	Combination
Die Zugehörigkeit	Affiliation
Das Momma	Momma
Der Umhang	Cape
Der Scheinwerfer	Headlight
Der Gouverneur	Governor
Die Sauerstoff	Oxygen
Der Bischof	Bishop
Das Bündel	Bundle
Die Entwicklung	Development
Der Fingernagel	Fingernail
Die Punktzahl	Score
Der Steuermann	Mate
Der Fahrer	Rider
Die Umlaufbahn	Orbit
Der Weinstock	Vine
Die Suite	Suite
Der Barkeeper	Bartender
Der Koks	Coke
Die Melodie	Tune
Die Herrlichkeit	Glory
Der Rabbi	Rabbi
Die Operation	Surgery
Das Vieh	Cattle
Das Ritual	Ritual
Die Begrüßung	Greeting
Die Scheibe	Slice
Die Homer	Homer
Der Kamin	Fireplace
Das Trikot	Jersey
Die Medien	Media
Die Pop	Pop
Die Fracht	Cargo
Das Gasthaus	Inn
Der Stellvertretende	Deputy
Die Verzweiflung	Despair
Das Territorium	Territory
Der Schlag	Punch
Die Jazz	Jazz
Die Umarmung	Hug
Die Pfeife	Whistle
Die Menschlichkeit	Humanity
Das Handwerk	Craft
Das Tageslicht	Daylight
Der Wert	Worth
Der Slip	Slip
Die Rüstung	Armor
Der Rucksack	Backpack
Der Vorschlag	Suggestion
Die Höhle	Den
Das Symbol	Symbol
Die Kolonie	Colony
Das Fazit	Conclusion
Das Nasenloch	Nostril
Der Speer	Spear
Der Impuls	Impulse
Die Tomate	Tomato
Das Kalb	Calf
Der Herbst	Autumn
Der Fund	Discovery
Das Klassenzimmer	Classroom
Die Lieferung	Delivery
Das Spray	Spray
Die Flüssigkeit	Liquid
Die Kraftstoff	Fuel
Die Unterwäsche	Underwear
Die Kuppel	Dome
Die Bevölkerung	Population
Die Neigung	Affection
Die Religion	Religion
Der Sänger	Singer
Der Begleiter	Attendant
Die Illusion	Illusion
Der Link	Link
Das Wohnzimmer	Lounge
Der Innenraum	Interior
Die Achselzucken	Shrug
Die Zone	Zone
Der Standard	Standard
Die Kohlen	Coal
Die Jagd	Chase
Der Klumpen	Lump
Der Charm	Charm
Die Legende	Legend
Die Konsequenz	Consequence
Die Beobachtung	Observation
Das Fahrrad	Bicycle
Der Schaden	Harm
Die Zahlung	Pay
Das Prospekt	Prospect
Die UBahn	Subway
Das Muster	Sample
Die Kirsche	Cherry
Der Händler	Dealer
Die Zuordnung	Assignment
Die Eile	Hurry
Die Geliebte	Mistress
Der Hügel	Mound
Der Unsinn	Nonsense
Das Komitee	Committee
Das Echo	Echo
Der Durchhang	Slack
Die Decker	Decker
Das Warenhaus	Warehouse
Der Kampf	Bout
Der Toast	Toast
Die Einrichtung	Facility
Der Basketball	Basketball
Der Schnurrbart	Mustache
Der Senator	Senator
Das Teilen	Share
Das Augenlid	Eyelid
Die Begeisterung	Enthusiasm
Die Chunk	Chunk
Die Schildkröte	Turtle
Der Alkohol	Alcohol
Die Gummi	Gum
Der Truthahn	Turkey
Der Prediger	Preacher
Der Besitz	Possession
Der Dolly	Dolly
Das Leinen	Linen
Die Entschuldigung	Apology
Der Vortrag	Lecture
Der Stein	Boulder
Der Heap	Heap
Der Fotograf	Photographer
Die Bremse	Brake
Die Nachfrage	Demand
Die Schürze	Apron
Der Mantel	Cloak
Die Jury	Jury
Die Anhörung	Hearing
Das Graue	Gray
Die Kiste	Crate
Die Methode	Method
Die Referenz	Reference
Der Ekel	Disgust
Die Flotte	Liquor
Der Lippenstift	Lipstick
Der Kern	Core
Der Einzelne	Individual
Der Container	Container
Die Hure	Whore
Das Kleinkind	Infant
Die Sonnenbrille	Sunglasses
Der Schlauch	Hose
Das Konzert	Concert
Das Bullshit	Bullshit
Die Eisenbahn	Railroad
Die Parade	Parade
Das Fach	Compartment
Der Bewohner	Resident
Der Backofen	Oven
Der Techniker	Technician
Das Verfahren	Procedure
Der Kämpfer	Fighter
Das Korn	Grain
Das Picknick	Picnic
Der Stamm	Tribe
Die Knospe	Bud
Die Wiese	Meadow
Die Öffentlichkeit	Public
Das Gift	Poison
Der Büffel	Buffalo
Die Region	Region
Die Produktion	Production
Das Rennen	Running
Die Schleife	Loop
Der Schlaf	Sleeping
Die Soda	Soda
Die Eule	Owl
Das Menü	Menu
Der Kick	Kick
Die Ruine	Ruin
Die Rampe	Ramp
Der Streifen	Streak
Unterarm	Forearm
Das Büro	Bureau
Der Achsschenkel	Knuckle
Die Gans	Goose
Der Vormarsch	Advance
Die Fee	Fairy
Die Krankheit	Illness
Die Mannschaft	Squad
Das Offizielle	Official
Die Marke	Brand
Die Orgel	Organ
Der Schmetterling	Butterfly
Das Reich	Empire
Das Profil	Profile
Die Freiheit	Liberty
Der Unglaube	Disbelief
Der Hain	Grove
Das Schild	Shield
Der Sattel	Saddle
Die Chancen	Odds
Die Cluster	Cluster
Der Satellit	Satellite
Der Abzug	Trigger
Der Welpe	Puppy
Die Warte	Waiting
Die Glühbirne	Bulb
Die Kommode	Dresser
Die Patrouille	Patrol
Der Adler	Eagle
Der Privatsphäre	Privacy
Das Fluid	Fluid
Die Herde	Herd
Der Kopfschmerz	Headache
Der Vergnügungspark	Amusement
Der Rollstuhl	Wheelchair
Die Richtlinie	Policy
Das Belle	Belle
Die Tabak	Tobacco
Die Einstellung	Setting
Die Tätowierung	Tattoo
Die Last	Burden
Der Händler	Merchant
Die Rutsche	Slide
Der Fleck	Stain
Das Essen	Eating
Die Bindung	Bond
Das Schwimmen	Swimming
Die Grundlage	Foundation
Die Verletzung	Injury
Die Liga	League
Die Batterie	Battery
Der Regenschirm	Umbrella
Der Kaiser	Emperor
Der Pier	Pier
Der Wasserhahn	Tap
Der Witz	Wit
Der Cutter	Cutter
Der Dachboden	Attic
Der Tiger	Tiger
Die Pal	Pal
Der Vorfahr	Ancestor
Die Konzentration	Concentration
Der Berg	Mount
Der Aufwand	Expense
Der Segen	Blessing
Der Urlaub	Leave
Die Leiste	Ledge
Die Fackel	Torch
Die Tinten	Ink
Die Handlung	Plot
Die Miete	Rent
Das Maultier	Mule
Der Bogen	Arch
Die Umgebung	Environment
Das Stirnrunzeln	Frown
Der Inspektor	Inspector
Die Mitten	Midst
Die Verlegenheit	Embarrassment
Die Beschwerde	Complaint
Die Portion	Portion
Das Spannfutter	Chuck
Die Clearing	Clearing
Die Krise	Crisis
Die Halskette	Necklace
Die Laterne	Lantern
Der Reichtum	Wealth
Der Mörder	Murderer
Die Zivilisation	Civilization
Das Konzept	Concept
Das Lamm	Lamb
Die Schritt	Stride
Die Manschette	Cuff
Die Jungfrau	Virgin
Das Eichhörnchen	Squirrel
Das Kind	Babe
Der Star	Starling
Die Depression	Depression
Das Speicher	Storage
Der Altar	Altar
Die Tragödie	Tragedy
Die Ressource	Resource
Der Reisende	Traveler
Das Vertrauen	Trust
Die Bogen	Arc
Das Königreich	Kingdom
Das Juwel	Jewel
Der Musiker	Musician
Das Flugzeug	Airplane
Die Junk	Junk
Der Sonnenschein	Sunshine
Der Knabe	Lad
Der Elf	Elf
Der Protest	Protest
Die Jagd	Hunt
Die Exekutive	Executive
Das Tagebuch	Diary
Das Aspekt	Aspect
Das Zifferblatt	Dial
Der Hausschuh	Slipper
Die Schauspielerin	Actress
Das Shooting	Shooting
Der Ohrring	Earring
Die Ameise	Ant
Die Patty	Patty
Die Sauce	Sauce
Die Rakete	Missile
Die Intensität	Intensity
Der Graben	Ditch
Das Gänseblümchen	Daisy
Die Kapelle	Chapel
Der Sumpf	Swamp
Die Beziehung	Relation
Die Vermutung	Guess
Der Kran	Crane
Die Begegnung	Encounter
Die Sequenz	Sequence
Das Fragment	Fragment
Der Entwurf	Draft
Das Diner	Diner
Die Funktion	Function
Die Organisation	Organization
Das Skelett	Skeleton
Das Elend	Misery
Das Kraut	Herb
Der Stumpf	Stump
Der Einsatz	Stake
Die Puff	Puff
Die Kreation	Creation
Das Gefolge	Wake
Der Zauberer	Wizard
Die Matte	Mat
Die Dichtung	Seal
Das Zwielicht	Twilight
Das Grunzen	Grunt
Die Strafe	Punishment
Der Clan	Clan
Das Kupfer	Copper
Die Trümmer	Debris
Der Maler	Painter
Das Steuer	Steering
Die Mathematik	Math
Die Erkennung	Recognition
Die Stimmung	Temper
Das Bedauern	Regret
Das Ziel	Destination
Die Mühle	Mill
Der Fehler	Error
Die Romantik	Romance
Das Thema	Topic
Die Terrasse	Patio
Die Schaufel	Shovel
Die Schlafanzüge	Pajamas
Die Email	EMail
Die Taube	Pigeon
Der Dinosaurier	Dinosaur
Die Branche	Industry
Der Betreiber	Operator
Der Lift	Lift
Der Ratgeber	Counselor
Die Versammlung	Gathering
Das Prinzip	Principle
Das Drama	Drama
Das Küken	Chick
Das Diagramm	Chart
Die Kampagne	Campaign
Der Lorbeer	Laurel
Das Steak	Steak
Der Kriminelle	Criminal
Der Globus	Globe
Der Bluterguss	Bruise
Der Knopf	Knob
Das Töten	Killing
Der Schatz	Sweetheart
Die Oper	Opera
Der Frost	Frost
Der Nippel	Nipple
Der Pfarrer	Reverend
Die Trübung	Haze
Das Hochwasser	Flood
Das Weihnachtslied	Carol
Die Schwäche	Weakness
Das Kochen	Cooking
Der Metzger	Butcher
Der Würfel	Cube
Der Keller	Cellar
Der Hohl	Hollow
Der Höcker	Bump
Der Halt	Halt
Das Heu	Hay
Die Rinde	Bark
Die Überlebens	Survival
Die Etagen	Bunk
Die Biegung	Bend
Die Freigabe	Approval
Der Unternehmensbereich	Division
Der Cocktail	Cocktail
Der Wettbewerb	Contest
Das Paradies	Paradise
Das Rasiermesser	Razor
Der Fang	Catch
Die Blüte	Blossom
Die Pfütze	Puddle
Der Strom	Electricity
Die Zwiebel	Onion
Die Laser	Laser
Das Kissen	Cushion
Der Einfluss	Influence
Der Sprung	Jump
Der Zement	Cement
Die Gelbe	Amber
Die Göttin	Goddess
The Shack	Shack
Die Verkäufe	Sales
Die Drift	Drift
Die Kämpfe	Fighting
Das Geflecht	Braid
Das Thema	Theme
Die Würde	Dignity
Die Zitrone	Lemon
Der Clown	Clown
Der Angriff	Assault
Die Brille	Goggle
Die Zerstörung	Destruction
Die Ausnahme	Exception
Der Pfirsich	Peach
Die Wasch	Wash
Die Befreiung	Release
Der Spion	Spy
Die Tag	Tag
Der Bh	Bra
Die Schuld	Debt
Die Terrasse	Terrace
Die Überbleibsel	Remains
Die Logik	Logic
Der Joint	Joint
Der Krug	Pitcher
Die Perspektive	Perspective
Die Ernte	Crop
Der Diplom	Graduate
Der Chor	Chorus
Der Überlebende	Survivor
Die Bezahlung	Payment
Die Wette	Bet
Die Rache	Revenge
Der Platz	Plaza
Der Ältere	Elder
Der Ingwer	Ginger
Der Chirurg	Surgeon
Der Bindestrich	Dash
Die Sandale	Sandal
Der Hass	Hatred
Die Abfahrt	Departure
Der Umriss	Outline
Der Rabe	Raven
Der Läufer	Runner
Die Vorfreude	Anticipation
Die Übersetzung	Translation
Das Hauptquartier	Headquarters
Feier	Celebration
Die Qual	Agony
Die Turnschuhe	Sneakers
Das Terminal	Terminal
Die Erwartung	Expectation
Die Weide	Pasture
Die Konsole	Console
Der Streik	Strike
Die Rettung	Rescue
Das Abzeichen	Badge
Der Fonds	Fund
Der Versuch	Try
Das Foyer	Foyer
Der Pastor	Pastor
Die Umarmung	Embrace
Das Puzzle	Puzzle
Der Kanal	Canal
Die Wohlfahrt	Charity
Der Direktor	Principal
Der Applaus	Applause
Die Philosophie	Philosophy
Der Graben	Trench
Die Bis	Up
Der Neffe	Nephew
Der Aufsatz	Essay
Die Reparatur	Repair
Der Mix	Mix
Der Mob	Mob
Die Barriere	Barrier
Die Platte	Disk
Die Güte	Goodness
Der Scout	Scout
Die Wichtigkeit	Importance
Das Schicksal	Destiny
Die Beihilfen	Aid
Das Mikrofon	Microphone
Das Etikett	Label
Der Pfeffer	Pepper
Der Kojote	Coyote
Das Lehren	Teaching
Der Brennvorgang	Burn
Die Weste	Vest
Das Pony	Pony
Der Esel	Donkey
Der Kreislauf	Cycle
Das Keuchen	Gasp
Die Ironie	Irony
Die Auszeichnung	Award
Die Traube	Grape
Das Zögern	Hesitation
Die Taverne	Tavern
Die Lästige Pflicht	Chore
Die Kugel	Sphere
Das Segel	Sail
Die Silhouette	Silhouette
Das Institut	Institute
Der Lügner	Liar
Die Technik	Technique
Der Index	Index
Das Brett	Plank
Der Ruck	Jerk
Das Wachstum	Growth
Der Strumpf	Stocking
Die Schwärze	Blackness
Der Teenager	Teen
Das Armband	Bracelet
Gelee	Jelly
Die Diät	Diet
Das Fleisch	Beef
Der Beton	Concrete
Der Kontrast	Contrast
Das Banner	Banner
Der Widerstand	Resistance
Der Aufenthalt	Stay
Die Haltung	Posture
Der Wodka	Vodka
Das Album	Album
Die Ära	Era
Die Bekanntschaft	Acquaintance
Die Revolution	Revolution
Der Nap	Nap
Der Schleier	Veil
Das Schauspiel	Spectacle
Der Wettbewerb	Competition
Die Kopfhaut	Scalp
Die Stechpalme	Holly
Der Gewinner	Winner
Der Appetit	Appetite
Der Efeu	Ivy
Der Cue	Cue
Der Stamm	Strain
Die Nichte	Niece
Die Galaxie	Galaxy
Die Nacht	Bedside
Die Verrücktheit	Madness
Der Bäcker	Baker
Das Virus	Virus
Das Leiden	Suffering
Der Schlitz	Slot
Der Ordner	Folder
Das Bekenntnis	Confession
Der Gepäckträger	Porter
Das Dessert	Dessert
Die Müllhalde	Dump
Das Paket	Packet
Der Gewinn	Profit
Der Enkel	Grandchild
Der Tratsch	Gossip
Die Stute	Mare
Die Dna	Dna
Der Rumpf	Torso
Der Besen	Broom
Der Huf	Hoof
Der Sensor	Sensor
Der Bauer	Peasant
Der Gelehrte	Scholar
Die Therapie	Therapy
Die Erdnuss	Peanut
Die Schlagzeile	Headline
Der Speck	Bacon
Das Heck	Stern
Die Geige	Violin
Die Pest	Plague
Die Unschärfe	Blur
Die Zwischenzeit	Meantime
Der Diakon	Deacon
Die Lanze	Lance
Die Festnahme	Arrest
Die Banane	Banana
Der Gin	Gin
Die Weide	Willow
Der Hai	Shark
Die Vorbereitung	Preparation
Die Kratz	Scratch
Der Verband	Dressing
Die Unterschrift	Signature
Der Admiral	Admiral
Die Analyse	Analysis
Der Regenbogen	Rainbow
Die Eidechse	Lizard
Der Zwerg	Dwarf
Der Stress	Stress
Die Hausaufgabe	Homework
Die Mischung	Mixture
Der Vers	Verse
Die Überzeugung	Conviction
Der Rover	Rover
Der Zaunkönig	Wren
Die Verbindung	Compound
Die Expedition	Expedition
Die Belohnung	Reward
Die Säulen	Pillar
Die Marmelade	Jam
Der Schnaps	Brandy
Die Residenz	Residence
Der Baron	Baron
Das Unternehmen	Enterprise
Der Komplex	Complex
Der Kandidat	Candidate
Der Triumph	Triumph
Die Wendung	Twist
Die Skizze	Sketch
Das Register	Register
Der Herzschlag	Heartbeat
Die Cafeteria	Cafeteria
Die Gebühr	Fee
Die Hang	Hillside
Das Labyrinth	Maze
Der Fischer	Fisherman
Das Brummen	Hum
Das Kätzchen	Kitten
The Dread	Dread
Die Substanz	Substance
Die Melodie	Melody
Der Knall	Bang
Der Dolch	Dagger
Die Absicht	Intent
Das Con	Con
Die Einsamkeit	Loneliness
Das Motorrad	Motorcycle
Das Staunen	Amazement
Die Peer	Peer
Die Tech	Tech
Die Beleidigung	Insult
Die Kapazität	Capacity
Die Ehrfurcht	Awe
Die Chili	Chili
Die Lodge	Lodge
Der Clip	Clip
Die Limousine	Limo
Die Mücke	Mosquito
Der Würfel	Dice
Der Shake	Shake
Das Festmahl	Feast
Das Casino	Casino
Die Erbse	Pea
Das Murmeln	Murmur
Der Konflikt	Conflict
Der Stamm	Stem
Der Genosse	Comrade
Die Herde	Flock
Sob	Sob
Die Schwangerschaft	Pregnancy
Der Verdächtige	Suspect
Das Zusammentreffen	Coincidence
Der Waldläufer	Ranger
Die Karikatur	Cartoon
Der Mitbewohner	Roommate
Die Freundlichkeit	Kindness
Der Kreuzer	Cruiser
Die Bramme	Slab
Das Gewissen	Conscience
Die Cheer	Cheer
Der Konus	Cone
Die Schaltung	Circuit
Das Elfenbein	Ivory
Der Zimmermann	Carpenter
Das Reich	Realm
Der Penner	Bum
Die Donna	Donna
Die Reservierung	Reservation
Die Unterhaltung	Entertainment
Die Krabbe	Crab
Das Stöhnen	Groan
Die Akademie	Academy
Die Sehnsucht	Longing
Die Kip	Kip
Der Bohrer	Drill
Das Gepäck	Luggage
Der Baldachin	Canopy
Der Nervenkitzel	Thrill
Die Tugend	Virtue
Der Sumpf	Marsh
Der Schornstein	Chimney
Die Anker	Anchor
Die Harmonie	Harmony
Das Ahorn	Maple
Das Kaninchen	Bunny
Der Modus	Mode
Der Thron	Throne
Der Antrag	Application
Die Physik	Physics
Das Neon	Neon
Die Luftschleuse	Airlock
Die Ermüdungs	Fatigue
Die Danksagung	Thanksgiving
Das Manuskript	Manuscript
Die Basis	Basis
Das Denkmal	Memorial
Der Schrank	Cupboard
Der Sprung	Leap
Die Japaner	Japanese
Das Engineering	Engineering
Die Linke	Left
Der Schmerz	Ache
Die Bronze	Bronze
Die Assoziation	Association
Die Flotte	Fleet
Der Marker	Marker
Die Beute	Prey
Die Taube	Dove
Der Griff	Grasp
Die Episode	Episode
Der Ursprung	Origin
Das Vakuum	Vacuum
Die Kathedrale	Cathedral
Das Management	Management
Die Nach Unten	Down
Der Kontinent	Continent
Zum Teufel	Dickens
Die Freiwillige	Volunteer
Fußball	Soccer
Der Saum	Hem
Die Erwähnung	Mention
Die Lust	Lust
Die Kichern	Giggle
Die Klassenkameraden	Classmate
Die Reinigung	Cleaning
Der Rezeptionist	Receptionist
Der Anrufer	Caller
Das Streben	Pursuit
Die Verachtung	Contempt
Das Opfer	Sacrifice
Die Großeltern	Grandparent
Der Grenzbereich	Threshold
Die Tat	Deed
Die Landschaft	Countryside
Das Artefakt	Artifact
Die Falten	Wrinkle
Der Magier	Magician
Der Stich	Pang
Die Italienische	Italian
Die Ewigkeit	Eternity
Der Schiefer	Slate
Das Treppenhaus	Stairwell
Die Ankündigung	Announcement
Das Motiv	Motive
Der Mechaniker	Mechanic
Der Verbündete	Ally
Die Vase	Vase
Der Verkäufer	Salesman
Der Therapeut	Therapist
Die Oma	Granny
Der Außenseiter	Maverick
Die Bandage	Bandage
Der Schinken	Ham
Der Fuhrmann	Carter
Die Investition	Investment
Die Beschwerde	Appeal
Die Unschuld	Innocence
Der Kalender	Calendar
Die Dach	Rooftop
Der Kampf	Combat
Die Offenbarung	Revelation
Der Pfannkuchen	Pancake
Der Asteroid	Asteroid
Die Postkarte	Postcard
Das Kleidungsstück	Garment
Die Bestimmung	Determination
Der Traktor	Tractor
Die Beere	Berry
Die Umgebung	Surroundings
Der Klumpen	Clump
Die Straftat	Offense
Die Einleitung	Introduction
Der Butler	Butler
Der Husten	Cough
Der Granit	Granite
Der Botschafter	Ambassador
Der Wende	Turning
Die Sitzung	Sitting
Das Kompliment	Compliment
Der Karton	Carton
Die Türklingel	Doorbell
Die Gewissheit	Certainty
Der Politiker	Politician
Die Dankbarkeit	Gratitude
Die Jetzige	Current
Das Dunkel	Gloom
Der Putz	Plaster
Die Siedlung	Settlement
Die Chop	Chop
Die Mordkommission	Homicide
Die Aluminium	Aluminum
Der Boulevard	Boulevard
Der Schüler	Pupil
Der Schwimmer	Float
Der Beruf	Profession
Der Rückzug	Retreat
Der Schnittpunkt	Intersection
Die Regelung	Scheme
Die Leere	Emptiness
Der Verlag	Publisher
Der Zirkus	Circus
Die Abmessung	Dimension
Der Tierpark	Zoo
Die Krankheit	Sickness
Der Bote	Messenger
Das Beau	Beau
Das Gewirr	Tangle
Das Personal	Personnel
Die Strategie	Strategy
Die Verzweiflung	Desperation
Der Geschäftsmann	Businessman
The Pod	Pod
Der Abfluss	Drain
Die Erdbeere	Strawberry
Der Jahrestag	Anniversary
Das Fernglas	Binoculars
Die Kluft	Gulf
Die Disziplin	Discipline
Die Hecke	Hedge
Das Stöhnen	Moan
Das Einkommen	Income
Der Mythos	Myth
Der Verschluss	Shutter
Das Floß	Raft
Der Arzt	Physician
Der Ehrgeiz	Ambition
Das Kamel	Camel
Das Schlagen	Beating
Die Säure	Acid
Müsli	Cereal
Das Becken	Basin
Das Nachthemd	Nightgown
Das Internet	Internet
Das Cockpit	Cockpit
Das Wrack	Wreck
Die Perücke	Wig
Darin	Rein
Der Recorder	Recorder
Das Schweinefleisch	Pork
Der Hund	Hound
Die Grenze	Boundary
Die Prüfung	Exam
Die Höflichkeit	Courtesy
Die Hilfe	Assistance
Die Wangenknochen	Cheekbone
Die Peitsche	Whip
Der Pilger	Pilgrim
Das Fett	Grease
Der Kollaps	Collapse
Die Fakultät	Faculty
Die Erinnerung	Reminder
Der Weise	Sage
Der Asphalt	Asphalt
Das Privileg	Privilege
Das Treppenhaus	Stairway
Die Wartung	Maintenance
Die Süße	Sweetie
Der Obstgarten	Orchard
Das Kinderbett	Cot
Der Beutel	Pouch
Das Feuerzeug	Lighter
Die Katze	Kitty
Die Formation	Formation
Die Snack	Snack
Das Reden	Talking
Die Op	Op
Der Schrei	Shriek
Die Skulptur	Sculpture
Der Vorsitzende	Chairman
Die Summe	Sum
Die Karotte	Carrot
Die Welligkeit	Ripple
Der Streifen	Stripe
Die Höhle	Cavern
Die Radar	Radar
Der Pferdeschwanz	Ponytail
Der Designer	Designer
Die Stoß	Surge
Der Erbe	Heir
Der Bunker	Vault
Die Sissy	Sissy
Die Schotten	Scotch
Die Stille	Stillness
Die Tunika	Tunic
Der Think	Think
Der Penis	Penis
Der Einheimische	Native
Das Liebesspiel	Lovemaking
Der Adjutant	Aide
Der Großteil	Bulk
Die Poker	Poker
Der Kalk	Lime
Das Überwachungs	Surveillance
Die Versammlung	Assembly
Der Enkel	Grandson
Der Chopper	Chopper
Der Träger	Carrier
Die Verlobung	Engagement
Das Kin	Kin
Die Mama	Mum
Die Beleuchtung	Lighting
Die Passform	Fit
Die Pull	Pull
The Verge	Verge
Das Bauernhaus	Farmhouse
Das Warten	Wait
Der Attentäter	Assassin
Der Schaum	Foam
Der Schlepper	Tug
Der Journalist	Journalist
Die Aufnahme	Recording
Die Heilung	Cure
Der Abstieg	Descent
Das Klingeln	Ringing
Die Schere	Scissors
Der Zweig	Twig
Der Urlaubsort	Resort
Der Beschützer	Guardian
Der Gegner	Opponent
Der Küchenchef	Chef
Der Weizen	Wheat
Der Hurrikan	Hurricane
Der Spielplatz	Playground
Der Pilz	Mushroom
Die Tastatur	Keyboard
Die Zeder	Cedar
Das Wappen	Crest
Der Jasmin	Jasmine
Der Sessel	Armchair
Die Attraktion	Attraction
Blinde	Blind
Zylinder	Cylinder
Die Schwalbe	Swallow
Die Berühmtheit	Celebrity
Die Wildnis	Wilderness
Das Dreieck	Triangle
Der Gestank	Stench
Das Labor	Laboratory
Das Array	Array
The Valentine	Valentine
Das Renten	Retirement
Der Ski	Ski
Die Ausgabe	Edition
Der Supervisor	Supervisor
Die Weite	Expanse
Das Ende	Ending
Das Moos	Moss
Der Sturm	Gale
Die Treue	Loyalty
Der Lavendel	Lavender
Die Begnadigung	Pardon
Der Aschenbecher	Ashtray
Die Scherbe	Shard
Das Unternehmen	Corporation
Die Ablenkung	Distraction
Die Majestät	Majesty
Die Pyramide	Pyramid
Der Ruhm	Fame
Der Schulabschluss	Graduation
Die Not	Distress
Der Magier	Mage
Die Unabhängigkeit	Independence
Der Schwarm	Crush
Das Lachen	Chuckle
Die Dime	Dime
Das Ziel	Aim
Die Böen	Gust
Der Russe	Russian
Der Festlichkeit	Treat
Der Ausländer	Foreigner
Das Gehalt	Salary
Der Anwendungsbereich	Scope
Der Rebell	Rebel
Der Schläger	Thug
Das Grab	Tomb
Der Kühlschrank	Fridge
Die Steckdose	Socket
Die Dosis	Dose
Die Wahl	Election
Der Flüchtling	Refugee
Die Phase	Phase
Der Kürbis	Pumpkin
Der Dorn	Thorn
Die Haut	Hide
Die Wurst	Sausage
Die Dig	Dig
Der Tan	Tan
Das Darlehen	Loan
Der Dorn	Spike
Die Krume	Crumb
Das Wachs	Wax
Das Knurren	Growl
Die Vermietung	Rental
Das Futter	Feed
Die Eskorte	Escort
Das Erstaunen	Astonishment
Die Flora	Flora
Das Fest	Festival
Die Debatte	Debate
Der Kritiker	Critic
Die Besetzung	Cast
Die Blüte	Bloom
Das Loft	Loft
Die Kommission	Commission
Das Flimmern	Flicker
Die Wirtschaft	Economy
Die Strahlung	Radiation
Der Leibwächter	Bodyguard
Die Umsetzung	Realization
Der Krater	Crater
Die Reise	Voyage
Das Kongress	Congress
Die Wahl	Vote
Der Antrag	Proposal
Der Braten	Fry
Das Zittern	Shiver
Die Verpflichtung	Obligation
Der Verlierer	Loser
Der Lehrer	Instructor
Die Zuzwinkern	Wink
Die Kies	Pebble
Die Notwendigkeit	Necessity
Der Workshop	Workshop
Der Sonnenaufgang	Sunrise
Die Erschöpfung	Exhaustion
Die Zelle	Cubicle
Der Doppelgänger	Double
Der Umfang	Perimeter
Der Kamm	Comb
Das Ende	Finish
Der Kauf	Purchase
Das Intervall	Interval
Der Spritz	Splash
Die Konvention	Convention
Das Bewusstsein	Awareness
Die Pose	Pose
Die Wiege	Cradle
Der Stößel	Ram
Der Adel	Gentry
Die Naht	Seam
Das Assoziierte Unternehmen	Associate
Die Scheibe	Pane
Der Punk	Punk
Der Überrest	Remnant
Der Cracker	Cracker
Der Bluff	Bluff
Die Düne	Dune
Der Zahnarzt	Dentist
Die Zuflucht	Refuge
Die Satin	Satin
Die Verbreitung	Spread
Das Unternehmen	Entity
Das Postfach	Mailbox
Der Ärger	Annoyance
Das Zischen	Hiss
Das Lokal	Local
Der Bums	Thud
Die Bestürzung	Dismay
Das Mehl	Flour
Der Freak	Freak
Der Haarschnitt	Haircut
Die Süße	Sweet
Die Waise	Orphan
Das Schach	Chess
Die Blütenblatt	Petal
Die Schreibarbeit	Paperwork
Der Psychiater	Psychiatrist
Der Gesang	Singing
Das Interrupt	Interrupt
Die Untersuchung	Examination
Die Bewunderung	Admiration
Das Gefrier	Freezer
Die Illustration	Illustration
Der Eintopf	Stew
Der Ermittler	Investigator
Der Vorort	Suburb
Der Keks	Biscuit
Das Holster	Holster
Der Faktor	Factor
Die Intimität	Intimacy
Die Peitsche	Lash
Die Einsparung	Saving
Die Software	Software
Die Henne	Hen
Die Birke	Birch
Die Untersuchung	Inquiry
Der Kindergarten	Nursery
Der Transport	Transport
Das Ausmaß	Extent
Die Definition	Definition
Das Monument	Monument
Die Pflaume	Plum
Das Nichts	Void
Die Verzögerung	Delay
Die Inspektion	Inspection
Die Essenz	Essence
Die Kanone	Cannon
Die Fransen	Fringe
Die Stereo	Stereo
Die Fella	Fella
Das Lob	Praise
Der Pinguin	Penguin
Die Folter	Torture
Die Briefmarke	Stamp
Die Partikel	Particle
Der Übersetzer	Translator
Ostern	Easter
Das Einfrieren	Freeze
Die Pew	Pew
Der Pfropfen	Wad
Das Höschen	Panties
Die Gegenleistung	Consideration
Der Spieß	Spit
Der Kühler	Cooler
Der Grill	Grill
Der Krug	Jug
Der Spitzname	Nickname
Der Revolver	Revolver
Die Maschinen	Machinery
Die Damen Und Herren	Madam
Der Hecht	Pike
Der Terrorist	Terrorist
Der Laptop	Laptop
Das Angebot	Offering
Der Schnabel	Beak
Die Institution	Institution
Der Vergleich	Comparison
Der Macher	Maker
Die Einsicht	Insight
Die Geschwister	Sibling
Der Kleiderschrank	Wardrobe
Die Klappe	Flap
Der Einzige	Sole
Das Mitgefühl	Compassion
Das Ego	Ego
Die Antennen	Antenna
Die Grille	Cricket
Der Troll	Troll
Der Bücherladen	Bookstore
Die Ankunft	Coming
Der Einwand	Objection
Der Halter	Holder
Rücksitz	Backseat
Die Unwissenheit	Ignorance
Das Budget	Budget
Das Flugzeug	Aircraft
Das Korps	Corps
Das Brot	Loaf
Die Erweiterung	Extension
Die Autobahn	Freeway
Die Einsamkeit	Solitude
Die Chemische	Chemical
Der Dorfbewohner	Villager
Die Perfektion	Perfection
Der Papst	Pope
Das Semester	Semester
Die Leber	Liver
Die Untertasse	Saucer
Die Dringlichkeit	Urgency
Der Vulkan	Volcano
Die Würze	Spice
Die Geisel	Hostage
Der Chor	Choir
Der Teig	Dough
Die Aufregung	Commotion
Gerichtsgebäude	Courthouse
Der Lachs	Salmon
Der Boxer	Boxer
Die Besorgung	Errand
Wobei Der Mechanismus	Mechanism
Das Teleskop	Telescope
Die Fähre	Ferry
Der Nigger	Nigger
Der Passant	PasserBy
Die Reizung	Irritation
Die Limousine	Sedan
Das Engagement	Commitment
Der Feigling	Coward
Die Git	Git
Die Fackel	Flare
Das Heulen	Howl
Die Fang	Fang
Die Römisch	Roman
Der Farbton	Hue
Das Unbehagen	Discomfort
Das Entlüftungs	Vent
Das Kanu	Canoe
Das Rezept	Recipe
Der Hamburger	Hamburger
Die Traufe	Eave
Der Barbier	Barber
Das Ableben	Passing
Der Verrat	Betrayal
Das Sweatshirt	Sweatshirt
Die Tentakel	Tentacle
Die Brandung	Surf
Das Plaid	Plaid
Der Gehweg	Walkway
Das Hinken	Limp
Die Verwaltung	Administration
Die Bequemlichkeit	Convenience
Die Windel	Diaper
Der Maulwurf	Mole
Der Reiniger	Cleaner
Die Dünung	Swell
Der Erwachsene	GrownUp
Die Scan	Scan
Die Klarheit	Clarity
Der Salon	Salon
Der Produzent	Producer
Die Flug	Flying
Der Rechtsmittelgrund	Plea
Die Prärie	Prairie
Der Pass	Passport
Die Alternative	Alternative
Die Eitelkeit	Vanity
Der Damm	Dam
Der Missbrauch	Abuse
Die Olive	Olive
Der Bergmann	Miner
Die Reserve	Reserve
Die Sicherungs	Backup
Die Gegensprechanlage	Intercom
Das Tuch	Shawl
Der Plattenteller	Platter
Die Implikation	Implication
Das Poltern	Rumble
Der Ansager	Announcer
Die Trümmer	Rubble
Die Axt	Axe
Die Übertragungs	Transmission
Die Krippe	Crib
Die Sprung	Hop
Der Friedhof	Graveyard
Das Aroma	Aroma
Der Dialog	Dialogue
Die Walze	Roller
Gemeinde	Congregation
Das Gelände	Terrain
Der Transfer	Transfer
Die Hardware	Hardware
Der Generator	Generator
Die Luxus	Luxury
Das Auditorium	Auditorium
Der Kobold	Goblin
Der Zapfen	Peg
Die Niederlage	Defeat
The Haven	Haven
Die Probe	Specimen
Der Herd	Hearth
Die Zulassung	Admission
Die Besessenheit	Obsession
Der Start	Launch
Die Patsy	Patsy
Das Wohnheim	Dorm
The Glen	Glen
Die Säge	Saw
Die Til	Til
Der Affe	Ape
Der Staffelungs	Stagger
Die Fotze	Pussy
Der Sammler	Collector
Das Erdbeben	Earthquake
Die Flocke	Flake
Die Silbe	Syllable
Das Bouquet	Bouquet
Die Auswahl	Selection
Der Schwur	Vow
Die Enkelin	Granddaughter
Das Symptom	Symptom
Das Szenario	Scenario
Der Aufruhr	Riot
Das Timing	Timing
Der Burger	Burger
Die Plus	Plus
Der Spatz	Sparrow
Die Botschaft	Embassy
Das Podium	Podium
Der Vorwurf	Accusation
Das Herrenhaus	Manor
Das Schlurfen	Shuffling
Der Delfin	Dolphin
Der Wasserkocher	Kettle
Der Soldat	Trooper
Die Rettung	Salvation
Der Tierarzt	Vet
Die Landebahn	Runway
Der Mohn	Poppy
Im Obergeschoss	Upstairs
Die Lava	Lava
Die Inspiration	Inspiration
Der Busen	Bosom
Der Eindringling	Intruder
Der Supermarkt	Supermarket
Der Pokal	Trophy
Die Eifersucht	Jealousy
Der Aufseher	Warden
Der Durchgang	Passageway
Der Yachthafen	Marina
Das Lebewohl	Farewell
Die Gegenstände	Belongings
Die Prozession	Procession
Der Astronaut	Astronaut
Der Schritt	Crotch
Die Sweep	Sweep
Die Erholung	Recovery
Der Kabelbaum	Harness
Die Angst	Anguish
Das Logo	Logo
Der Wurf	Litter
Die Marine	Marine
Der Groll	Resentment
Der CoOp	CoOp
The Drake	Drake
Der Zigeuner	Gypsy
Die Nachahmung	Imitation
Der Arbeitgeber	Employer
Der Neuling	Freshman
Das Phänomen	Phenomenon
Die Flöte	Flute
Der Grieche	Greek
Die Wohnung	Condo
Der Zeigefinger	Forefinger
Das Begräbnis	Burial
Die Republik	Republic
Der Smaragd	Emerald
Der Bademantel	Bathrobe
Das Zeugnis	Testimony
Das Scharnier	Hinge
Die Bäckerei	Bakery
Der Kontext	Context
Das Schnäppchen	Bargain
Das Sprichwort	Saying
Der Vorarbeiter	Foreman
Der Schwan	Swan
Die Flanell	Flannel
Die Angabe	Indication
Die Signifikanz	Significance
Der Käfer	Beetle
Die Lern	Learning
Das Lokal	Pub
Die Fraktion	Fraction
Die Forelle	Trout
Die Kruste	Crust
Die Überzugs	Overcoat
Das Glitzern	Glint
Die Medaille	Medal
Die Wahrnehmung	Perception
Das Willkommen	Welcome
Das Wörterbuch	Dictionary
Die Metapher	Metaphor
Die Armut	Poverty
Die Haupt	Main
Der Anstieg	Climb
Die Leine	Leash
