die Zeit	the time
das Jahr	the year
die Menschen	people
der Weg	the way
der Tag	the day
der Mann	the man
die Sache	the thing
die Frau	the woman
das Leben	the life
das Kind	the child
der Anruf	the call
die Welt	the world
die Schule	the school
das Gefühl	the feeling
der Staat	the state
die meisten	most
die Familie	the family
der Student	the student
die Gruppe	the group
das Land	the country
das Problem	the problem
die Hand	the hand
der Teil	the part
der Ort	the place
der Fall	the case
die Woche	the week
das Unternehmen	the company
das System	the system
das Programm	the program
die Frage	the question
die Arbeit	the work
die Regierung	the government
die Nummer	the number
die Nacht	the night
der Herr	the Mr
die Stelle	the point
die million	million
das Zuhause	the home
das Wasser	the water
das Zimmer	the room
die Mutter	the mother
das Gebiet	the area
das Geld	the money
die Geschichte	the story
die Tatsache	the fact
der Monat	the month
das Ganze	the lot
das Recht	the right
die Studium	the study
das Buch	the book
das Auge	the eye
die Arbeit	the job
das Wort	the word
das Geschäft	the business
das Thema	the issue
die Seite	the side
die Art	the kind
der Kopf	the head
das Haus	the house
der Service	the service
der Freund	the friend
der Vater	the father
die Macht	the power
die Stunde	the hour
das Spiel	the game
die Linie	the line
das Ende	the end
das Mitglied	the member
das Gesetz	the law
das Auto	the car
die Stadt	the city
die Gemeinde	the community
der Name	the name
der Präsident	the president
das Team	the team
die Minute	the minute
die Idee	the idea
das Kind	the kid
der Körper	the body
die Information	the information
der Rücken	the back
das Elternteil	the parent
das Gesicht	the face
die Anderen	the others
die Ebene	the level
das Büro	the office
die Tür	the door
die Gesundheit	the health
die Person	the person
die Kunst	the art
der Krieg	the war
die Geschichte	the history
die Party	the party
das Ergebnis	the result
der Wechsel	the change
der Morgen	the morning
der Grund	the reason
die Forschung	the research
das Mädchen	the girl
der Kerl	the guy
das Essen	the food
der Moment	the moment
die Luft	the air
der Lehrer	the teacher
die Kraft	the force
das Angebot	the offer
die Erziehung	the education
der Fuß	the foot
der Junge	the boy
das Alter	the age
die Richtlinie	the policy
der Prozess	the process
die Musik	the music
der Markt	the market
der Sinn	the sense
die Nation	the nation
der Plan	the plan
die Hochschule	the college
die Interesse	the interest
der Tod	the death
die Erfahrung	the experience
der Effekt	the effect
die Verwendung	the use
die Klasse	the class
die Kontrolle	the control
die Pflege	the care
das Feld	the field
die Entwicklung	the development
die Rolle	the role
der Aufwand	the effort
die Rate	the rate
das Herz	the heart
das Medikament	the drug
die Show	the show
der Leiter	the leader
das Licht	the light
die Stimme	the voice
die Frau	the wife
die Polizei	the police
der Verstand	the mind
der Preis	the price
der Bericht	the report
die Entscheidung	the decision
der Sohn	the son
die Aussicht	the view
die Beziehung	the relationship
die Stadt	the town
die Straße	the road
der Arm	the arm
der Unterschied	the difference
der Wert	the value
das Gebäude	the building
die Aktion	the action
das Model	the model
die Saison	the season
die Gesellschaft	the society
die Steuer	the tax
der Direktor	the director
die Position	the position
der Spieler	the player
der Datensatz	the record
das Papier	the paper
der Raum	the space
der Boden	the ground
die Form	the form
das Ereignis	the event
das offizielle	the official
der Grund	the matter
das Zentrum	the center
das Ehepaar	the couple
der Standort	the site
das Projekt	the project
die Aktivität	the activity
der Stern	the star
der Tisch	the table
das Bedürfnis	the need
das Gericht	the court
die Amerikaner	the American
das Öl	the oil
die Situation	the situation
die Kosten	the cost
die Branche	the industry
die Figur	the figure
die Straße	the street
das Bild	the image
das Telefon	the phone
die Daten	the data
das Bild	the picture
die Übung	the practice
das Stück	the piece
das Land	the land
das Produkt	the product
der Doktor	the doctor
die Mauer	the wall
der Patient	the patient
der Arbeiter	the worker
die Nachrichten	the news
der Test	the test
der Film	the movie
der Norden	the north
die Liebe	the love
die Unterstützung	the support
die Technologie	the technology
der Schritt	the step
das Baby	the baby
der Computer	the computer
der Typ	the type
die Aufmerksamkeit	the attention
der Film	the film
die Republikaner	the Republican
der Baum	the tree
die Quelle	the source
die Organisation	the organization
das Haar	the hair
das Aussehen	the look
das Jahrhundert	the century
der Beweis	the evidence
das Fenster	the window
die Kultur	the culture
die Chance	the chance
der Bruder	the brother
die Energie	the energy
die Periode	the period
der Kurs	the course
der Sommer	the summer
die Pflanze	the plant
die Gelegenheit	the opportunity
der Begriff	the term
der Buchstabe	the letter
die Bedingung	the condition
die Wahl	the choice
die Regel	the rule
die Tochter	the daughter
die Verwaltung	the administration
der Süden	the south
der Ehemann	the husband
der Kongress	the Congress
der Boden	the floor
die Kampagne	the campaign
das Material	the material
die Bevölkerung	the population
der Anruf	the call
die Wirtschaft	the economy
das Krankenhaus	the hospital
die Kirche	the church
das Risiko	the risk
das Feuer	the fire
die Zukunft	the future
die Verteidigung	the defense
die Sicherheit	the security
die Bank	the bank
der Westen	the west
der Sport	the sport
die Tafel	the board
das Thema	the subject
der Beamte	the officer
der Rest	the rest
das Verhalten	the behavior
die Performance	the performance
die Spitze	the top
das Ziel	the goal
der Zweite	the second
das Bett	the bed
die Bestellung	the order
der Autor	the author
das Blut	the blood
die Agentur	the agency
die Natur	the nature
die Farbe	the color
das Geschäft	the store
der Klang	the sound
in der Nähe von	near
die Bewegung	the movement
die Seite	the page
das Rennen	the race
die Sorge	the concern
die Serie	the series
die Sprache	the language
die Antwort	the response
das Tier	the animal
der Faktor	the factor
das Jahrzehnt	the decade
der Artikel	the article
der Osten	the east
der Künstler	the artist
die Szene	the scene
die Aktie	the stock
die Karriere	the career
die Behandlung	the treatment
die Vorgehensweise	the approach
die Größe	the size
der Hund	the dog
die Kaution	the fund
die Medien	the media
das Schild	the sign
der Gedanke	the thought
die Liste	the list
der Einzelne	the individual
die Qualität	the quality
der Druck	the pressure
die Antwort	the answer
die Ressource	the resource
das Treffen	the meeting
die Krankheit	the disease
der Erfolg	the success
die Tasse	the cup
die Summe	the amount
die Fähigkeit	the ability
das Personal	the staff
der Charakter	the character
das Wachstum	the growth
der Verlust	the loss
das Grad	the degree
der Angriff	the attack
die Region	the region
das Fernsehen	the television
die Kiste	the box
der Fernseher	the TV
das Training	the training
der Handel	the trade
der Deal	the deal
die Wahl	the election
das Gefühl	the feeling
der Standard	the standard
die Rechnung	the bill
die Nachricht	the message
die Analyse	the analysis
der Vorteil	the benefit
das Geschlecht	the sex
der Rechtsanwalt	the lawyer
die Sektion	the section
das Glas	the glass
das Können	the skill
die Schwester	the sister
der Professor	the professor
die Operation	the operation
das Verbrechen	the crime
die Bühne	the stage
die Autorität	the authority
die Fräulein	the miss
das Design	the design
die Art	the sort
der Eine	the one
das Wissen	the knowledge
die Waffe	the gun
der Bahnhof	the station
die Strategie	the strategy
die Wahrheit	the truth
das Lied	the song
das Beispiel	the example
die Umgebung	the environment
das Bein	the leg
die Öffentlichkeit	the public
die Exekutive	the executive
der Satz	the set
der Stein	the rock
die Notiz	the note
der Geschäftsführer	the manager
die Hilfe	the help
das Netzwerk	the network
die Wissenschaft	the science
die Erinnerung	the memory
die Karte	the card
der Sitz	the seat
die Zelle	the cell
die Studie	the trial
der Experte	the expert
der Frühling	the spring
die Firma	the firm
der Demokrat	the Democrat
das Radio	the radio
das Management	the management
der Ball	the ball
das Gespräch	the talk
die Theorie	the theory
der Aufprall	the impact
die Aussage	the statement
die Ladung	the charge
die Richtung	the direction
die Waffe	the weapon
der Arbeitnehmer	the employee
der Frieden	the peace
die Basis	the base
der Schmerz	the pain
das Spiel	the play
die Maßnahme	the measure
das Interview	the interview
der Stuhl	the chair
der Fisch	the fish
die Kamera	the camera
die Struktur	the structure
die Politiker	the politics
das Bit	the bit
das Gewicht	the weight
der Kandidat	the candidate
die Produktion	the production
die Reise	the trip
der Abend	the evening
die Konferenz	the conference
die Einheit	the unit
der Style	the style
der erwachsene	the adult
die Reichweite	the range
die Vergangenheit	the past
die Kante	the edge
der Schriftsteller	the writer
die Schwierigkeiten	the trouble
die Herausforderung	the challenge
die Angst	the fear
die Schulter	the shoulder
die Institution	the institution
das Meer	the sea
der Traum	the dream
die Bar	the bar
die Eigenschaft	the property
das Zeug	the stuff
das Detail	the detail
die Methode	the method
die Zeitschrift	the magazine
das Hotel	the hotel
der Soldat	the soldier
die Ursache	the cause
die Tasche	the bag
die Hitze	the heat
der Herbst	the fall
die Ehe	the marriage
die Oberfläche	the surface
die Absicht	the purpose
das Muster	the pattern
die Haut	the skin
der Agent	the agent
der Besitzer	the owner
die Maschine	the machine
das Gas	the gas
die Generation	the generation
der Krebs	the cancer
der Gegenstand	the item
die Realität	the reality
der Trainer	the coach
der Hof	the yard
die Gewalt	the violence
die Investition	the investment
die Diskussion	the discussion
der Finger	the finger
der Garten	the garden
die Sammlung	the collection
die Aufgabe	the task
der Partner	the partner
die Küche	the kitchen
der Verbraucher	the consumer
der Schuss	the shot
das Budget	the budget
das Gemälde	the painting
der Wissenschaftler	the scientist
die Vereinbarung	the agreement
die Hauptstadt	the capital
der Mund	the mouth
das Opfer	the victim
die Zeitung	the newspaper
die Drohung	the threat
die Verantwortung	the responsibility
der Anwalt	the attorney
die Punktzahl	the score
das Konto	the account
die Pause	the break
die Zuschauer	the audience
das Abendessen	the dinner
die Debatte	the debate
der Bürger	the citizen
die Mehrheit	the majority
der Wind	the wind
die Mission	the mission
der Kunde	the customer
die Rede	the speech
die Option	the option
der Teilnehmer	the participant
der Wald	the forest
das Video	the video
der Senat	the Senate
die Reform	the reform
der Zugang	the access
das Restaurant	the restaurant
der Richter	the judge
die Beziehung	the relation
der Vogel	the bird
die Meinung	the opinion
der Kredit	the credit
die Ecke	the corner
die Version	the version
die Sicherheit	the safety
die Nachbarschaft	the neighborhood
der Akt	the act
das Einkommen	the income
die Arten	the species
die Strecke	the track
die Hoffnung	the hope
der Himmel	the sky
die Freiheit	the freedom
das Flugzeug	the plane
das Objekt	the object
die Attitüde	the attitude
das Konzept	the concept
der Kunde	the client
die Unterhaltung	the conversation
die Vielfalt	the variety
die Wende	the turn
die Ermittlung	the investigation
der Forscher	the researcher
die Presse	the press
der Konflikt	the conflict
der Geist	the spirit
das Argument	the argument
das Lager	the camp
das Gehirn	the brain
das Merkmal	the feature
der Nachmittag	the afternoon
das Wochenende	the weekend
die Möglichkeit	the possibility
die Versicherung	the insurance
die Abteilung	the department
der Kampf	the battle
der Anfang	the beginning
das Datum	the date
die Krise	the crisis
der Fan	the fan
das Loch	the hole
das Element	the element
die Vision	the vision
der Status	the status
das Schiff	the ship
die Lösung	the solution
der Stein	the stone
die Skala	the scale
die Universität	the university
der Fahrer	the driver
der Versuch	the attempt
der Park	the park
die Stelle	the spot
der Mangel	the lack
das Eis	the ice
das Boot	the boat
die Sonne	the sun
die Distanz	the distance
das Holz	the wood
der LKW	the truck
die Rückkehr	the return
der Berg	the mountain
die Umfrage	the survey
die Tradition	the tradition
der Winter	the winter
das Dorf	the village
die Verkäufe	the sales
die Kommunikation	the communication
der Lauf	the run
der Bildschirm	the screen
der Bewohner	the resident
das Gold	the gold
der Klub	the club
der Bauernhof	the farm
der Anstieg	the increase
die Mitte	the middle
das Vorhandensein	the presence
das Viertel	the district
die Form	the shape
der Leser	the reader
der Vertrag	the contract
die Menge	the crowd
das Apartment	the apartment
die Stärke	the strength
die Band	the band
das Pferd	the horse
das Ziel	the target
das Gefängnis	the prison
die Wache	the guard
die Nachfrage	the demand
der Reporter	the reporter
der Text	the text
das Teilen	the share
das Werkzeug	the tool
das Fahrzeug	the vehicle
der Flug	the flight
die Einrichtung	the facility
das Verständnis	the understanding
der Vorteil	the advantage
die Führung	the leadership
das Pfund	the pound
die Basis	the basis
der Gast	the guest
die Probe	the sample
der Block	the block
der Schutz	the protection
die Identität	the identity
der Titel	the title
der Unterricht	the lesson
der Glaube	the faith
der Fluss	the river
die Lebenden	the living
die Technik	the technique
der Weg	the path
das Ohr	the ear
das Volk	the folk
das Prinzip	the principle
die Grenze	the border
der Wettbewerb	the competition
die Forderung	the claim
die Ausrüstung	the equipment
der Kritiker	the critic
der Aspekt	the aspect
der Fehlschlag	the failure
der Kommentar	the comment
die Affäre	the affair
das Verfahren	the procedure
der Vorsitzende	the chairman
der Baseball	the baseball
das Ei	the egg
der Glaube	the belief
der Mord	the murder
das Geschenk	the gift
die Religion	the religion
die Überprüfung	the review
der Editor	the editor
der Kaffee	the coffee
das Dokument	the document
die Geschwindigkeit	the speed
der Einfluss	the influence
die Jugend	the youth
die Welle	the wave
die Bewegung	the move
das Viertel	the quarter
der Hintergrund	the background
die Reaktion	the reaction
der Anzug	the suit
die Perspektive	the perspective
die Konstruktion	the construction
die Intelligenz	the intelligence
die Verbindung	the connection
der Schuh	the shoe
die Note	the grade
der Kontext	the context
das Komitee	the committee
der Fehler	the mistake
der Fokus	the focus
das Lächeln	the smile
der Standort	the location
die Kleidung	the clothes
der Nachbar	the neighbor
die Fahrt	the drive
die Funktion	the function
der Knochen	the bone
die durchschnittliche	the average
der Wein	the wine
der Wähler	the voter
das Lernen	the learning
der Bus	the bus
die Hölle	the hell
die Kategorie	the category
der Sieg	the victory
der Schlüssel	the key
der Besuch	the visit
das Internet	the Internet
die Medizin	the medicine
die Reise	the tour
das Foto	the photo
das Klassenzimmer	the classroom
der Kontakt	the contact
die Gerechtigkeit	the justice
das Paar	the pair
die Übung	the exercise
das Knie	the knee
die Blume	the flower
das Band	the tape
die Versorgung	the supply
der Schnitt	the cut
der Wille	the will
der Schauspieler	the actor
die Geburt	the birth
die Suche	the search
die Demokratie	the democracy
der Kreis	the circle
das Gerät	the device
der Fortschritt	the progress
die Front	the front
die Insel	the island
der Austausch	the exchange
das Studio	the studio
die Dame	the lady
der Kollege	the colleague
die Anwendung	the application
der Hals	the neck
der Schaden	the damage
der Kunststoff	the plastic
der Teller	the plate
das Schreiben	the writing
der Anfang	the start
der Ausdruck	the expression
der Fußball	the football
das Huhn	the chicken
die Armee	the army
der Missbrauch	the abuse
das Theater	the theater
die Karte	the map
die Sitzung	the session
die Gefahr	the danger
die Literatur	the literature
der Regen	the rain
das Verlangen	the desire
die Beurteilung	the assessment
die Verletzung	the injury
der Respekt	the respect
der Treibstoff	the fuel
das Blatt	the leaf
die Anleitung	the instruction
der Kampf	the fight
der Pool	the pool
die Führung	the lead
der Motor	the engine
das Salz	the salt
die Wichtigkeit	the importance
das Metall	the metal
das Fett	the fat
das Ticket	the ticket
die Software	the software
die Lippe	the lip
das Lesen	the reading
das Mittagessen	the lunch
der Bauer	the farmer
der Zucker	the sugar
der Planet	the planet
der Feind	the enemy
der Athlet	the athlete
die Seele	the soul
die Platte	the panel
die Bedeutung	the meaning
die Mutter	the mom
das Instrument	the instrument
das Wetter	the weather
das Engagement	the commitment
die Tasche	the pocket
die Temperatur	the temperature
die Überraschung	the surprise
die Umfrage	the poll
der Antrag	the proposal
die Konsequenz	the consequence
die Hälfte	the half
der Atem	the breath
die Sicht	the sight
die Titelseite	the cover
die Balance	the balance
die Minderheit	the minority
die Werke	the works
das Lehren	the teaching
die Hilfe	the aid
der Ratschlag	the advice
die Fotografie	the photograph
der Pfad	the trail
der Roman	the novel
der Code	the code
die Jury	the jury
die Brust	the breast
der Mensch	the human
der Sturm	the storm
die Union	the union
der Schreibtisch	the desk
die dank	the thanks
das Obst	the fruit
das Fazit	the conclusion
der Schatten	the shadow
der Analytiker	the analyst
der Tanz	the dance
das Limit	the limit
die Regulation	the regulation
das Sein	the being
der Ring	the ring
die Einnahmen	the revenue
der Kreis	the county
die Erscheinung	the appearance
das Paket	the package
die Schwierigkeit	the difficulty
die Brücke	the bridge
der Zug	the train
die Email	the e-mail
das Denken	the thinking
die Tendenz	the trend
der Besucher	the visitor
das Darlehen	the loan
der Anleger	the investor
der Profit	the profit
die Besatzung	the crew
der Unfall	the accident
der männliche	the male
die Mahlzeit	the meal
die Anhörung	the hearing
der Verkehr	the traffic
der Muskel	the muscle
die Vorstellung	the notion
die Erde	the earth
die Brust	the chest
das Geld	the cash
das Museum	the museum
die Schönheit	the beauty
der Notfall	the emergency
der Stress	the stress
der Inhalt	the content
der Ursprung	the root
die Nase	the nose
die Flasche	the bottle
die Einstellung	the setting
das Kleid	the dress
die Datei	the file
das Ergebnis	the outcome
die Anzeige	the ad
die Pflicht	the duty
das Blatt	the sheet
das Ausmaß	the extent
die Komponente	the component
der Kontrast	the contrast
die Zone	the zone
der Flughafen	the airport
der Chef	the chief
das Hemd	the shirt
der Pilot	the pilot
die Katze	the cat
der Beitrag	the contribution
die Kapazität	the capacity
das Anwesen	the estate
der Führer	the guide
der Schnee	the snow
der Politiker	the politician
der Prozentanteil	the percentage
das Fleisch	the meat
die Erde	the soil
die Operation	the surgery
der Basketball	the basketball
der Golf	the golf
die Kette	the chain
die Adresse	the address
die Branche	the branch
die Kombination	the combination
der Gouverneur	the governor
das Relief	the relief
der Benutzer	the user
der Vater	the dad
die Methode	the manner
die Stille	the silence
das Rating	the rating
das Geschlecht	the gender
die Gebühr	the fee
die Landschaft	the landscape
die Schale	the bowl
der Rahmen	the frame
der Gastgeber	the host
die Halle	the hall
der Ozean	the ocean
die Reihe	the row
der Produzent	the producer
das Regime	the regime
der Unternehmensbereich	the division
die Beschwerde	the appeal
der Spiegel	the mirror
der Zahn	the tooth
die Länge	the length
die Variable	the variable
das Telefon	the telephone
die Wahrnehmung	the perception
das Vertrauen	the confidence
das Schlafzimmer	the bedroom
das Geheimnis	the secret
die Schuld	the debt
der Panzer	the tank
die Krankenschwester	the nurse
die Abdeckung	the coverage
die Opposition	the opposition
die Bindung	the bond
die Freude	the pleasure
der Meister	the master
die Ära	the era
die Anforderung	the requirement
die Prüfung	the check
der Stand	the stand
der Spaß	the fun
die Erwartung	the expectation
der Flügel	the wing
das Urteil	the judgment
das Bier	the beer
das Englisch	the English
die Referenz	the reference
die Träne	the tear
der Zweifel	the doubt
der Minister	the minister
der Held	the hero
die Wolke	the cloud
der Gewinner	the winner
die Lautstärke	the volume
der Samen	the seed
die Mode	the fashion
der Pfeffer	the pepper
die Intervention	the intervention
die Kopie	the copy
das Trinkgeld	the tip
die Wohlfahrt	the welfare
das Gemüse	the vegetable
das Gericht	the dish
der Strand	the beach
die Verbesserung	the improvement
die Eröffnung	the opening
die Route	the route
die Liga	the league
der Kern	the core
der Aufgang	the rise
die Krawatte	the tie
der Urlaub	the holiday
die Auflösung	the resolution
der Haushalt	the household
die Abtreibung	the abortion
der Zeuge	the witness
der Sektor	the sector
der Abgeordnete	the representative
das Schwarze	the black
der Vorfall	the incident
die Strömung	the flow
die Fakultät	the faculty
der Müll	the waste
die Masse	the mass
das Experiment	the experiment
die Bombe	the bomb
der Ton	the tone
der Ingenieur	the engineer
das Rad	the wheel
das Weibchen	the female
das Versprechen	the promise
das Kabel	the cable
die AIDS	the AIDS
der Jude	the Jew
die Creme	the cream
die Sekretärin	the secretary
das Tor	the gate
der Hügel	the hill
der Lärm	the noise
das Gras	the grass
der Hut	the hat
die Gesetzgebung	the legislation
die Leistung	the achievement
das fischen	the fishing
das Getränk	the drink
das Talent	the talent
der Geschmack	the taste
das Merkmal	the characteristic
die Milch	the milk
der Satz	the sentence
die Höhe	the height
der Physiker	the physician
der Schlaf	the sleep
die Fahrt	the ride
die Erklärung	the explanation
der Campus	the campus
das Potenzial	the potential
der Immigrant	the immigrant
die Alternative	the alternative
die Interaktion	the interaction
die Kolumne	the column
die Persönlichkeit	the personality
das Signal	the signal
der Lebenslauf	the curriculum
die Ehre	the honor
der Passagier	the passenger
die Unterstützung	the assistance
der Verein	the association
das Labor	the lab
das Angebot	the offer
die Kritik	the criticism
das Kapital	the asset
die Depression	the depression
der Journalist	the journalist
das Gebet	the prayer
der Gelehrte	the scholar
die Warnung	the warning
das Klima	the climate
der Käse	the cheese
die Beobachtung	the observation
die Kindheit	the childhood
die Bezahlung	the payment
der sir	the sir
die Zigarette	the cigarette
die Definition	the definition
die Priorität	the priority
das Brot	the bread
die Kreation	the creation
der Absolvent	the graduate
die Anfrage	the request
das Gefühl	the emotion
das Universum	the universe
die Lücke	the gap
der Staatsanwalt	the prosecutor
die Note	the mark
das Grün	the green
die Fluggesellschaft	the airline
die Bibliothek	the library
die Tagesordnung	the agenda
die Fabrik	the factory
die Auswahl	the selection
das Dach	the roof
die Kosten	the expense
die Initiative	the initiative
die Diät	the diet
die finanzierung	the funding
die Therapie	the therapy
der Stundenplan	the schedule
das Gehäuse	the housing
die Post	the post
die Dunkelheit	the dark
der Stahl	the steel
der Chip	the chip
das Ich	the self
das Fahrrad	the bike
der Tee	the tea
der Vergleich	the comparison
die Siedlung	the settlement
die Schicht	the layer
die Planung	the planning
die Beschreibung	the description
die Hochzeit	the wedding
die Portion	the portion
das Territorium	the territory
der Gegner	the opponent
der Link	the link
der See	the lake
die Spannung	the tension
der Bildschirm	the display
der Alkohol	the alcohol
der Gewinn	the gain
die Wüste	the desert
der Fehler	the error
die Freisetzung	the release
der Polizist	the cop
das Wandern	the walk
der Sand	the sand
der Schlag	the hit
der Druck	the print
der Durchgang	the passage
der Übergang	the transition
die Existenz	the existence
das Album	the album
die Teilnahme	the participation
der Kreislauf	the cycle
das Ganze	the whole
der Widerstand	the resistance
die Entdeckung	the discovery
die Belichtung	the exposure
der Strom	the stream
der Verkauf	the sale
das Vertrauen	the trust
der Topf	the pot
die Koalition	the coalition
das Märchen	the tale
das Messer	the knife
die Phase	the phase
das Geschenk	the present
der Witz	the joke
der Mantel	the coat
das Symptom	the symptom
der Hersteller	the manufacturer
die Philosophie	the philosophy
die Kartoffel	the potato
die Grundlage	the foundation
der Pass	the pass
die Verhandlung	the negotiation
der Anlass	the occasion
der Staub	the dust
die Ermittler	the investigator
die Jacke	the jacket
die Reduzierung	the reduction
die Verschiebung	the shift
der Selbstmord	the suicide
die Berührung	the touch
die Substanz	the substance
die Disziplin	the discipline
das Bügeleisen	the iron
die Leidenschaft	the passion
die Freiwillige	the volunteer
die Durchsetzung	the enforcement
die Soße	the sauce
die Unabhängigkeit	the independence
das Marketing	the marketing
der Priester	the priest
der Fortschritt	the advance
der Arbeitgeber	the employer
der Schock	the shock
die Krankheit	the illness
die Kappe	the cap
die Angewohnheit	the habit
der Saft	the juice
die Beteiligung	the involvement
der Inder	the Indian
das Unglück	the disaster
der Parkplatz	the parking
das Prospekt	the prospect
der Chef	the boss
die Beschwerde	the complaint
die Meisterschaft	the championship
das Mysterium	the mystery
die Armut	the poverty
der Eintritt	the entry
die Ausgaben	the spending
der König	the king
das Symbol	the symbol
der Macher	the maker
die Stimmung	the mood
der Schwerpunkt	the emphasis
das Boot	the boot
die Unterhaltung	the entertainment
die Bohne	the bean
die Bewertung	the evaluation
die Kreatur	the creature
der Kommandant	the commander
die Anordnung	the arrangement
die Gesamt	the total
die Wut	the anger
der Spitzer	the peak
die Störung	the disorder
die Rakete	the missile
das Kabel	the wire
die Runde	the round
der Vertrieb	the distribution
der Transport	the transportation
der Zwilling	the twin
der Befehl	the command
die Kommission	the commission
die Interpretation	the interpretation
das Frühstück	the breakfast
der Halt	the stop
das Ingenieurwesen	the engineering
das Glück	the luck
die Klinik	the clinic
der Veteran	the veteran
die Esslöffel	the tablespoon
der Tourist	the tourist
die Tomate	the tomato
die Ausnahme	the exception
die Butter	the butter
das Defizit	the deficit
das Bad	the bathroom
der Verbündete	the ally
der Ruf	the reputation
die Mischung	the mixture
der Turm	the tower
der Rauch	the smoke
die Dimension	the dimension
das Spielzeug	the toy
der Häftling	the prisoner
in der Nähe	nearby
der Peer	the peer
der Designer	the designer
das Personal	the personnel
der Erzieher	the educator
die relativen	the relative
die Einwanderung	the immigration
der Gürtel	the belt
der Teelöffel	the teaspoon
der Geburtstag	the birthday
die Implikation	the implication
die Küste	the coast
der Unterstützer	the supporter
das Silber	the silver
der Teenager	the teenager
die Erkennung	the recognition
das Renten	the retirement
die Flagge	the flag
die Wiederherstellung	the recovery
die Uhr	the watch
der Gentleman	the gentleman
der Mais	the corn
der Mond	the moon
die Kehle	the throat
das Gehalt	the salary
der Beobachter	the observer
die Veröffentlichung	the publication
die Ernte	the crop
der Streik	the strike
das Phänomen	the phenomenon
die Angst	the anxiety
das Treffen	the convention
die Ausstellung	the exhibition
der Beobachter	the viewer
die Pfanne	the pan
der Berater	the consultant
der Administrator	the administrator
der Bürgermeister	the mayor
die Gegenleistung	the consideration
der Geschäftsführer	the CEO
die Schätzung	the estimate
der Bock	the buck
das Gedicht	the poem
die Großmutter	the grandmother
das Unternehmen	the enterprise
die Prüfung	the testing
der Magen	the stomach
der Vorschlag	the suggestion
die Post	the mail
das Rezept	the recipe
die Vorbereitung	the preparation
das Konzert	the concert
die Absicht	the intention
der Kanal	the channel
das Rohr	the tube
die Zeichnung	the drawing
das Protein	the protein
die Abwesenheit	the absence
die Rolle	the roll
das Gefängnis	the jail
die Vielfalt	the diversity
die Geschwindigkeit	the pace
die Anstellung	the employment
der Lautsprecher	the speaker
der Eindruck	the impression
der Aufsatz	the essay
der Antwortende	the respondent
der Kuchen	the cake
der Historiker	the historian
der Spezialist	the specialist
der Ursprung	the origin
die Freigabe	the approval
die Mine	the mine
der Fall	the drop
die Zählung	the count
die Tiefe	the depth
der Reichtum	the wealth
die Behinderung	the disability
die Muschel	the shell
der Profi	the professional
die Packung	the pack
die Zwiebel	the onion
der Stellvertreter	the deputy
die Marke	the brand
die Auszeichnung	the award
das Kriterium	the criteria
der Händler	the dealer
das Dienstprogramm	the utility
die Autobahn	the highway
die Routine	the routine
der Lohn	the wage
die Zutat	the ingredient
die Beteiligung	the stake
die Faser	the fiber
der Aktivist	the activist
der Terrorismus	the terrorism
der Flüchtling	the refugee
die Hüfte	the hip
die Annahme	the assumption
die Ausrüstung	the gear
die Barriere	the barrier
die Provision	the provision
der Mörder	the killer
die Gruppe	the gang
die Chemikalie	the chemical
das Etikett	the label
der Teenager	the teen
der Index	the index
der Urlaub	the vacation
der Anwalt	the advocate
der Entwurf	the draft
der Himmel	the heaven
das Drama	the drama
der Satellit	the satellite
das Wunder	the wonder
die Uhr	the clock
die Schokolade	the chocolate
die Decke	the ceiling
die Werbung	the advertising
die Taste	the button
die Glocke	the bell
der Rang	the rank
die Dunkelheit	the darkness
die Bekleidung	the clothing
der Zaun	the fence
das Porträt	the portrait
die Farbe	the paint
das Überleben	the survival
die Klage	the lawsuit
das Zeugnis	the testimony
das Bündel	the bunch
der Beat	the beat
die Last	the burden
die Kammer	the chamber
die Möbel	the furniture
die Kooperation	the cooperation
die Saite	the string
die Zeremonie	the ceremony
die Wange	the cheek
das Profil	the profile
der Mechanismus	the mechanism
die Strafe	the penalty
das Match	the match
das Resort	the resort
die Zerstörung	the destruction
der Bär	the bear
das Gewebe	the tissue
der Fremde	the stranger
die Infektion	the infection
das Kabinett	the cabinet
der Apfel	the apple
der Virus	the virus
der Streit	the dispute
das Glück	the fortune
der Assistent	the assistant
die Statistiken	the statistics
das Einkaufen	the shopping
der Cousin	the cousin
das weiß	the white
der Hafen	the port
der Strom	the electricity
der Berater	the adviser
die Bezahlung	the pay
der Sprecher	the spokesman
der Anreiz	the incentive
der Sklave	the slave
der Terror	the terror
die Erweiterung	the expansion
die Elite	the elite
der Dreck	the dirt
der Reis	the rice
die Kugel	the bullet
die Bibel	the Bible
die Grafik	the chart
der Rückgang	the decline
die konservative	the conservative
der Stock	the stick
die Konzentration	the concentration
der Meister	the champion
das Szenario	the scenario
das Teleskop	the telescope
die Reflektion	the reflection
die Revolution	the revolution
der Streifen	the strip
der Wettbewerb	the tournament
die Fiktion	the fiction
die Lebensdauer	the lifetime
die Empfehlung	the recommendation
der Senator	the senator
die Jagd	the hunting
der Salat	the salad
die Grenze	the boundary
die Zufriedenheit	the satisfaction
das Tagebuch	the journal
die Bank	the bench
der Liebhaber	the lover
das Bewusstsein	the awareness
die allgemeine	the general
das Deck	the deck
der Pol	the pole
der Modus	the mode
der Dialog	the dialogue
der Gründer	the founder
der Stolz	the pride
das Flugzeug	the aircraft
die Lieferung	the delivery
die Platform	the platform
die Finanzen	the finance
die Freude	the joy
der wert	the worth
der Sänger	the singer
das Shooting	the shooting
die Offensive	the offense
der Zähler	the counter
die DNA	the DNA
der Geruch	the smell
die Übertragung	the transfer
der Protest	the protest
der Absturz	the crash
das Handwerk	the craft
der Vertrag	the treaty
der Terrorist	the terrorist
die Einsicht	the insight
die Lüge	the lie
die Folge	the episode
die Mischung	the mix
der Angriff	the assault
die Treppen	the stair
das Abenteuer	the adventure
der Beweis	the proof
das Hauptquartier	the headquarters
die Verletzung	the violation
die Zunge	the tongue
die Lizenz	the license
der Halt	the hold
die Zuflucht	the shelter
die Kontroverse	the controversy
der Eingang	the entrance
der Favorit	the favorite
die Tragödie	the tragedy
das Netz	the net
die Beerdigung	the funeral
der Beruf	the profession
die Einrichtung	the establishment
die Vorstellung	the imagination
die Maske	the mask
die Präsentation	the presentation
die Einleitung	the introduction
die Repräsentation	the representation
das Reh	the deer
die Partnerschaft	the partnership
die Verschmutzung	the pollution
die Emissions	the emission
das Schicksal	the fate
der Ofen	the oven
die Unterscheidung	the distinction
das Segment	the segment
der Poet	the poet
die Variation	the variation
der Komfort	the comfort
der Honig	the honey
der Korrespondent	the correspondent
der Musiker	the musician
die Signifikanz	the significance
die Ladung	the load
das Schiff	the vessel
der Speicher	the storage
das Leder	the leather
die Evolution	the evolution
der Stamm	the tribe
das Regal	the shelf
die Dose	the can
der Großvater	the grandfather
der Rasen	the lawn
der Käufer	the buyer
die Speise	the dining
die Weisheit	the wisdom
der Rat	the council
die Instanz	the instance
der Knoblauch	the garlic
die Fähigkeit	the capability
die Poesie	the poetry
der Prominente	the celebrity
die Stabilität	the stability
die Fantasie	the fantasy
die Handlung	the plot
der Rahmen	the framework
die Geste	the gesture
die Psychologie	the psychology
der Ratgeber	the counselor
das Kapitel	the chapter
der Gefährte	the fellow
die Scheidung	the divorce
das Rohr	the pipe
die Mathematik	the math
die Schattierung	the shade
der Schweif	the tail
die Verpflichtung	the obligation
der Winkel	the angle
die Palme	the palm
der Brauch	the custom
der Ökonom	the economist
die Suppe	the soup
die Feier	the celebration
die Zusammensetzung	the composition
der Stapel	the pile
der Kohlenstoff	the carbon
die Regelung	the scheme
der Riss	the crack
die Frequenz	the frequency
der Tabak	the tobacco
der Überlebende	the survivor
der Psychologe	the psychologist
die Galaxie	the galaxy
der Ski	the ski
die Begrenzung	the limitation
der Termin	the appointment
die Präferenz	the preference
der Meter	the meter
die Explosion	the explosion
die Festnahme	the arrest
der Kämpfer	the fighter
der Eintritt	the admission
der Jäger	the hunter
die Freundschaft	the friendship
der Adjutant	the aide
die Veranda	the porch
die Tendenz	the tendency
die Uniform	the uniform
die Formation	the formation
das Stipendium	the scholarship
die Reservierung	the reservation
die Effizienz	the efficiency
das Einkaufszentrum	the mall
der Skandal	the scandal
der PC	the PC
die Ferse	the heel
die Privatsphäre	the privacy
das Gewebe	the fabric
der Anteil	the proportion
die Leitlinie	the guideline
das Gewehr	the rifle
die Wartung	the maintenance
der Trick	the trick
das Zelt	the tent
die Untersuchung	the examination
der Herausgeber	the publisher
die Franzosen	the French
der Mythos	the myth
die Kuh	the cow
der Stand	the standing
das Tennis	the tennis
der Nerv	the nerve
das Fass	the barrel
das Bombardement	the bombing
die Mitgliedschaft	the membership
das Verhältnis	the ratio
das Menü	the menu
der Kauf	the purchase
der Lifestyle	the lifestyle
der Humor	the humor
der Handschuh	the glove
der Verdächtige	the suspect
die Erzählung	the narrative
der Fotograf	the photographer
der Hubschrauber	the helicopter
die katholische	the Catholic
der Provider	the provider
die Verzögerung	the delay
der Hub	the stroke
der Anwendungsbereich	the scope
die Bestrafung	the punishment
die Handvoll	the handful
der Horizont	the horizon
die Freundin	the girlfriend
das Cholesterin	the cholesterol
die Angleichung	the adjustment
die Steuerzahler	the taxpayer
der Rektor	the principal
die Motivation	the motivation
die Zuordnung	the assignment
die Beschränkung	the restriction
die palästinensische	the Palestinian
das Labor	the laboratory
der Workshop	the workshop
das Auto	the auto
die Baumwolle	the cotton
der Motor	the motor
der Geschmack	the flavor
die Sequenz	the sequence
die Demonstration	the demonstration
der Jet	the jet
der Verbrauch	the consumption
die Klinge	the blade
das Medikament	the medication
die Kajüte	the cabin
die Ausgabe	the edition
das Tal	the valley
die Tonhöhe	the pitch
der Kiefer	the pine
die Herstellungs	the manufacturing
der Christian	the Christian
der Komplex	the complex
der Küchenchef	the chef
die Diskriminierung	the discrimination
das deutsch	the German
der Boom	the boom
das Erbe	the heritage
der Gott	the God
die Scheiße	the shit
die Zitrone	the lemon
die Wirtschaft	the economics
die Nuss	the nut
das Vermächtnis	the legacy
die Erweiterung	the extension
die Fliege	the fly
die Batterie	the battery
die Ankunft	the arrival
die Ausrichtung	the orientation
die Inflation	the inflation
die Flamme	the flame
der Cluster	the cluster
die Wunde	the wound
die Dusche	the shower
das Betriebs	the operating
das Fleisch	the flesh
die Garage	the garage
der Betreiber	the operator
der Lehrer	the instructor
die Komödie	the comedy
die Hypothek	the mortgage
das Habitat	the habitat
das Getreide	the grain
das Bewußtsein	the consciousness
die Messung	the measurement
die Provinz	the province
die Ethik	the ethics
die Nominierung	the nomination
die Erlaubnis	the permission
die Schauspielerin	the actress
der Gipfel	the summit
die Säure	the acid
die Chancen	the odds
die Frustration	the frustration
das Medium	the medium
der Zuschuss	the grant
die Küste	the shore
die Lunge	the lung
der Diskurs	the discourse
der Korb	the basket
der Wettbewerber	the competitor
das Pulver	the powder
das Gespenst	the ghost
der Keks	the cookie
die Karriere	the carrier
das Kochen	the cooking
die Schaukel	the swing
die Orange	the orange
das Haustier	the pet
das Wunder	the miracle
der Rhythmus	the rhythm
das Töten	the killing
die Sünde	the sin
die Wohlfahrt	the charity
das Skript	the script
die Taktik	the tactic
die Identifikation	the identification
die Transformation	the transformation
die Schlagzeile	the headline
die Venture	the venture
die Invasion	the invasion
das Militär	the military
das Klavier	the piano
das Lebensmittelgeschäft	the grocery
die Intensität	the intensity
die Decke	the blanket
der Abstand	the margin
der Quarterback	the quarterback
die Maus	the mouse
das Seil	the rope
das Rezept	the prescription
der Ziegelstein	the brick
der Patch	the patch
der Konsens	the consensus
der Horror	the horror
die Aufnahme	the recording
der Maler	the painter
der Kuchen	the pie
das Wohl	the sake
der Blick	the gaze
der Mut	the courage
die Schwangerschaft	the pregnancy
der Hinweis	the clue
der Sieg	the win
die Verwirrung	the confusion
die Scheibe	the slice
die Tätigkeit	the occupation
die Kohle	the coal
der Kriminelle	the criminal
die Formel	the formula
der Onkel	the uncle
das Quadrat	the square
der Kapitän	the captain
die Gallerie	the gallery
der Verteidiger	the defendant
der Tunnel	the tunnel
die Fitness	the fitness
die Runde	the lap
das Grab	the grave
die Zehe	the toe
der Kontainer	the container
die Tugend	the virtue
der Architekt	the architect
das Make-Up	the makeup
die Anfrage	the inquiry
die Rose	the rose
die Angabe	the indication
die Schiene	the rail
der Jahrestag	the anniversary
die Couch	the couch
die Allianz	the alliance
die Hypothese	the hypothesis
der Freund	the boyfriend
die Unordnung	the mess
die Legende	the legend
der jugendliche	the adolescent
die Norm	the norm
die Bemerkung	the remark
die Belohnung	the reward
das Organ	the organ
das Lachen	the laughter
der Nordwesten	the northwest
die Beratung	the counseling
der Empfänger	the receiver
das Ritual	the ritual
das Insekt	the insect
der Lachs	the salmon
der Gefallen	the favor
das Handels	the trading
der Stamm	the stem
der Chirurg	the surgeon
die Physik	the physics
die Vergewaltigung	the rape
der Rat	the counsel
die Bürste	the brush
die Jeans	the jeans
das Protokoll	the log
die Pille	the pill
die Skulptur	the sculpture
die Verbindung	the compound
das Mehl	the flour
die Piste	the slope
die Präsidentschaft	the presidency
die Portion	the serving
der Bischof	the bishop
das trinken	the drinking
der Schrei	the cry
die Akzeptanz	the acceptance
der Kollaps	the collapse
die Pumpe	the pump
die Süßigkeit	the candy
das Böse	the evil
das endgültige	the final
die Medaille	the medal
die Ausfuhr	the export
die Mitternacht	the midnight
die Kurve	the curve
die Integrität	the integrity
die Logik	the logic
die Essenz	the essence
der Schrank	the closet
der Innenraum	the interior
der Korridor	the corridor
der Krug	the pitcher
die Schlange	the snake
das Kreuz	the cross
die Schwäche	the weakness
das Schwein	the pig
die Kälte	the cold
das T-Shirt	the T-shirt
die Arbeitslosigkeit	the unemployment
die Zivilisation	the civilization
der Pop	the pop
die Korrelation	the correlation
die Menschlichkeit	the humanity
der Entwickler	the developer
die Aufregung	the excitement
der Islam	the Islam
die Strecke	the stretch
die Architektur	the architecture
der Ellbogen	the elbow
der Muslim	the Muslim
die Ente	the duck
die Dosis	the dose
der Vortrag	the lecture
der Van	the van
die Bucht	the bay
die Vorstadt	the suburb
das Sandwich	the sandwich
der Kofferraum	the trunk
das Gerücht	the rumor
die Umsetzung	the implementation
die Kleidung	the cloth
die Wirksamkeit	the effectiveness
die Linse	the lens
die Reichweite	the reach
der Inspektor	the inspector
der Betrug	the fraud
der Begleiter	the companion
der Nagel	the nail
das Array	the array
die Ratte	the rat
der Flur	the hallway
die Höhle	the cave
der Südwesten	the southwest
das Monster	the monster
das Hindernis	the obstacle
die Begegnung	the encounter
das Kraut	the herb
die Integration	the integration
der Kristall	the crystal
die Rezession	the recession
der Wunsch	the wish
das Motiv	the motive
das Hochwasser	the flood
der Stift	the pen
das eigentum	the ownership
der Albtraum	the nightmare
die Bekanntmachung	the notice
die Inspektion	the inspection
der Vorgesetzte	the supervisor
die Arena	the arena
das Lachen	the laugh
die Diagnose	the diagnosis
der Besitz	the possession
der Keller	the basement
die Staatsanwaltschaft	the prosecution
die Ankündigung	the announcement
der Krieger	the warrior
die Vorhersage	the prediction
die Bakterien	the bacteria
der Fragebogen	the questionnaire
der Schlamm	the mud
die Infrastruktur	the infrastructure
das Privileg	the privilege
der Tempel	the temple
die Sendung	the broadcast
das Handgelenk	the wrist
der Vorhang	the curtain
der Monitor	the monitor
der Teich	the pond
die Domain	the domain
die Schuld	the guilt
das Vieh	the cattle
der gehende	the walking
die Playoff	the playoff
der Rock	the skirt
die Datenbank	the database
die Schenkel	the limb
die Ideologie	the ideology
der Schaden	the harm
die Eisenbahn	the railroad
die Strahlung	the radiation
das Horn	the horn
die Innovation	the innovation
die Gitarre	the guitar
der Ersatz	the replacement
der Tänzer	the dancer
die Änderung	the amendment
das Polster	the pad
die Übertragung	the transmission
die Gnade	the grace
die Kolonie	the colony
die Adoption	the adoption
die Rutsche	the slide
die zivile	the civilian
das Handtuch	the towel
die Partikel	the particle
der Blick	the glance
der Preis	the prize
die Landung	the landing
das Verhalten	the conduct
das Blaue	the blue
die Fledermaus	the bat
der Alarm	the alarm
das Fest	the festival
der Griff	the grip
der Neuling	the freshman
der Schweiß	the sweat
das Europäische	the European
die Trennung	the separation
der Südosten	the southeast
die Abstimmung	the ballot
die Rhetorik	the rhetoric
das Vitamin	the vitamin
die Begeisterung	the enthusiasm
die Wildnis	the wilderness
das Mandat	the mandate
die Pause	the pause
die Entschuldigung	the excuse
die Unsicherheit	the uncertainty
das Chaos	the chaos
die Leinwand	the canvas
die Lobby	the lobby
das Format	the format
die Währung	the currency
der Truthahn	the turkey
die Reserve	the reserve
der Strahl	the beam
der Astronom	the astronomer
die Korruption	the corruption
der Dienstleister	the contractor
die Lehre	the doctrine
der Daumen	the thumb
die Einheit	the unity
der Kompromiss	the compromise
der Ansturm	the rush
die Komplexität	the complexity
die Gabel	the fork
die Scheibe	the disk
der Verdacht	the suspicion
das Schloss	the lock
das Ende	the finish
die Residenz	the residence
die Schande	the shame
der Bürgersteig	the sidewalk
die Olympischen Spiele	the Olympics
die Unterschrift	the signature
der Rebell	the rebel
der Ehegatte	the spouse
die Flüssigkeit	the fluid
die Rente	the pension
das Natrium	the sodium
der Schlag	the blow
die Stirn	the forehead
der Haken	the hook
der Detektiv	the detective
der Reisende	the traveler
die Entschädigung	the compensation
der Ausgang	the exit
die Attraktion	the attraction
der Ladewagen	the pickup
die Nadel	the needle
der Bauch	the belly
das Portfolio	the portfolio
das Shuttle	the shuttle
das Timing	the timing
die Verlobung	the engagement
der Knöchel	the ankle
die Transaktion	the transaction
das Gegenstück	the counterpart
der Fahrer	the rider
die Puppe	the doll
der Mittag	the noon
die Ausstellung	the exhibit
das Kohlenhydrat	the carbohydrate
die Freiheit	the liberty
das Poster	the poster
die Theologie	the theology
der Sauerstoff	the oxygen
die Magie	the magic
die Summe	the sum
unter der Voraussetzung	provided
der Geschäftsmann	the businessman
die Entschlossenheit	the determination
der Spender	the donor
der Pfarrer	the pastor
der Jazz	the jazz
die Oper	the opera
die Japaner	the Japanese
der Biss	the bite
der Erwerb	the acquisition
die Grube	the pit
das wilde Leben	the wildlife
der Riese	the giant
der primäre	the primary
das Eigenkapital	the equity
die Tür	the doorway
die Abfahrt	the departure
der Aufzug	the elevator
die Fröhlichkeit	the happiness
die Statue	the statue
die Verfolgung	the pursuit
die Reparatur	the repair
das Fitnesscenter	the gym
der Angestellte	the clerk
die israelische	the Israeli
der Briefumschlag	the envelope
die Meldung	the reporting
die Faust	the fist
die Erforschung	the exploration
das Bad	the bath
die Rettung	the rescue
der Indikator	the indicator
das Sonnenlicht	the sunlight
die Rückmeldung	the feedback
das Spektrum	the spectrum
der Laser	the laser
das Know-how	the expertise
die Melodie	the tune
das Essen	the eating
der Hinweis	the hint
die Parade	the parade
das Reich	the realm
das Verbot	the ban
der Therapeut	the therapist
die Pizza	the pizza
der Empfänger	the recipient
die Buchhaltung	the accounting
die Bias	the bias
die Metapher	the metaphor
die Kerze	the candle
der Griff	the handle
die Sorge	the worry
das Leiden	the suffering
die Lampe	the lamp
der Müll	the garbage
der Diener	the servant
die Zugabe	the addition
das Innere	the inside
die Rezeption	the reception
das Kinn	the chin
die Notwendigkeit	the necessity
der Rassismus	the racism
der Beginner	the starter
das Banken	the banking
die Schwerkraft	the gravity
die Prävention	the prevention
die arabischen	the Arab
der Darsteller	the performer
das Inventar	the inventory
die Versammlung	the assembly
die Seide	the silk
die Größenordnung	the magnitude
die Geisel	the hostage
der Sammler	the collector
die Beliebtheit	the popularity
der Kuss	the kiss
das Alien	the alien
die gleichung	the equation
der Engel	the angel
der Schalter	the switch
das Angebot	the offering
die Wut	the rage
die Fotografie	the photography
die Toilette	the toilet
der Russe	the Russian
die wake	the wake
die Versammlung	the gathering
das Automobil	the automobile
die Morgendämmerung	the dawn
die Gezeiten	the tide
die Romanze	the romance
die Hardware	the hardware
das Kissen	the pillow
der Koch	the cook
die Verbreitung	the spread
der Kontinent	the continent
die Rennbahn	the circuit
das Waschbecken	the sink
die Regelung	the ruling
der Mangel	the shortage
die Falle	the trap
der Dummkopf	the fool
die Deadline	the deadline
das Verarbeiten	the processing
die Ranch	the ranch
der Diamant	the diamond
die Glaubwürdigkeit	the credibility
der Import	the import
die Stimmung	the sentiment
der Wagen	the cart
die Ältesten	the elder
die pro	the pro
die Inspiration	the inspiration
die Quantität	the quantity
der Trailer	the trailer
der Steuermann	the mate
das Genie	the genius
das Monument	the monument
das Streben	the quest
das Opfer	the sacrifice
die Einladung	the invitation
die Genauigkeit	the accuracy
der Juror	the juror
der Broker	the broker
der Schatz	the treasure
die Loyalität	the loyalty
das Benzin	the gasoline
die Ausgabe	the output
der Kandidat	the nominee
der Diabetes	the diabetes
der Kiefer	the jaw
die Trauer	the grief
die Rakete	the rocket
der Insasse	the inmate
die Dynamik	the dynamics
der Bogen	the bow
der Senior	the senior
die Würde	the dignity
der Teppich	the carpet
die Blase	the bubble
der Kumpel	the buddy
die Scheune	the barn
das Schwert	the sword
der Blitz	the flash
die Herrlichkeit	the glory
die Trommel	the drum
die Königin	the queen
das Dilemma	the dilemma
die Eingabe	the input
der Nordosten	the northeast
die Haftung	the liability
der Händler	the merchant
das Stadium	the stadium
die Niederlage	the defeat
der Rückzug	the withdrawal
der Kühlschrank	the refrigerator
das Nest	the nest
die Spur	the lane
der Dampf	the steam
der Akzent	the accent
die Flucht	the escape
der Käfig	the cage
die Krabbe	the shrimp
das Heimatland	the homeland
das Regal	the rack
das Kostüm	the costume
der Wolf	the wolf
das Statut	the statute
der Cartoon	the cartoon
die Produktivität	the productivity
die Dichtung	the seal
die Tante	the aunt
die Landwirtschaft	the agriculture
der Konkurs	the bankruptcy
der Impfstoff	the vaccine
der Bonus	the bonus
die Zusammenarbeit	the collaboration
die Umlaufbahn	the orbit
die Geduld	the patience
die Abstimmung	the voting
die Patrouille	the patrol
die Bereitschaft	the willingness
die Offenbarung	the revelation
die Miete	the rent
der Schmuck	the jewelry
die Spur	the trace
der Wagen	the wagon
die Verlässlichkeit	the reliability
der Esel	the ass
der Busch	the bush
der Clip	the clip
die Hüfte	the thigh
der Stier	the bull
die Schublade	the drawer
das Schaf	the sheep
der Koordinator	the coordinator
der Läufer	the runner
das Reich	the empire
das Taxi	the cab
die Dokumentation	the documentary
die Biologie	the biology
das Netz	the web
die Verschwörung	the conspiracy
der Fang	the catch
der Unfall	the casualty
die Republik	the republic
die Hinrichtung	the execution
der Wal	the whale
der Instinkt	the instinct
der Mitspieler	the teammate
das Aluminium	the aluminum
das Ministerium	the ministry
das Urteil	the verdict
der Schädel	the skull
das Selbstwertgefühl	the self-esteem
die Leichtigkeit	the ease
die Biene	the bee
der Praktiker	the practitioner
die Schleife	the loop
das Puzzle	the puzzle
der Pilz	the mushroom
die Subvention	the subsidy
die Mathematik	the mathematics
der Mechaniker	the mechanic
das Gefäss	the jar
das Erdbeben	the earthquake
das Schweinefleisch	the pork
die Kreativität	the creativity
das Dessert	the dessert
die Sympathie	the sympathy
der Fischer	the fisherman
die Isolierung	the isolation
die Socke	the sock
der Sprung	the jump
der Unternehmer	the entrepreneur
das Syndrom	the syndrome
das Büro	the bureau
der Arbeitsplatz	the workplace
der Ehrgeiz	the ambition
die Landung	the touchdown
die Brise	the breeze
das Christentum	the Christianity
die Übersetzung	the translation
die Eingeweide	the gut
die Kabine	the booth
der Helm	the helmet
die Taille	the waist
der Löwe	the lion
die Vollendung	the accomplishment
die Panik	the panic
die Besetzung	the cast
die Klippe	the cliff
die Schnur	the cord
das Kokain	the cocaine
die Illusion	the illusion
die Aufwertung	the appreciation
der Kommissar	the commissioner
die Flexibilität	the flexibility
das Casino	the casino
der Tumor	the tumor
der Puls	the pulse
das Äquivalent	the equivalent
die Spende	the donation
das Tagebuch	the diary
das Geschwister	the sibling
die Ironie	the irony
der Löffel	the spoon
die Mitte	the midst
die Gasse	the alley
die Seife	the soap
der Rivale	the rival
der Stecker	the pin
das Hockey	the hockey
der Zulieferer	the supplier
das Momentum	the momentum
der Geldbeutel	the purse
die Flüssigkeit	the liquid
das Symbol	the icon
der Elefant	the elephant
der Gesetzgeber	the legislature
die Gesellschafter	the associate
das Franchise	the franchise
das Fahrrad	the bicycle
das Fieber	the fever
der Filter	the filter
das Kaninchen	the rabbit
die Münze	the coin
der Organismus	the organism
die Sensation	the sensation
der Aufenthalt	the stay
das Minimum	the minimum
die Erhaltung	the conservation
der Hinterhof	the backyard
die Charta	the charter
der Herd	the stove
die Zustimmung	the consent
die Erinnerung	the reminder
die Platzierung	the placement
der Teig	the dough
der Enkel	the grandchild
der Damm	the dam
das Outfit	the outfit
der Kolumnist	the columnist
das Training	the workout
das Patent	the patent
das Zitat	the quote
das Hormon	the hormone
die Textur	the texture
der Bleistift	the pencil
der Frontmann	the frontier
das Spray	the spray
die Wette	the bet
die Verwahrung	the custody
der Banker	the banker
das Biest	the beast
die Eiche	the oak
das Notebook	the notebook
die Anwesenheit	the attendance
die Spekulation	the speculation
der Hai	the shark
die Mühle	the mill
die Installation	the installation
der Tag	the tag
das Schwimmen	the swimming
die Flotte	the fleet
der Katalog	the catalog
der Aussenseiter	the outsider
die Haltung	the stance
die Empfindlichkeit	the sensitivity
das Debüt	the debut
die Konfrontation	the confrontation
das Ideal	the ideal
die Verfassung	the constitution
der Trainer	the trainer
die Danksagung	the Thanksgiving
der Duft	the scent
der Stapel	the stack
die Augenbraue	the eyebrow
der Sack	the sack
die Schale	the tray
der Pionier	the pioneer
das Textbuch	the textbook
der Punkt	the dot
das Weizen	the wheat
das Königreich	the kingdom
der Gang	the aisle
das Protokoll	the protocol
der Markt	the marketplace
das Gelände	the terrain
die Pasta	the pasta
das Genre	the genre
das Verdienst	the merit
der Planer	the planner
der Chunk	the chunk
der Rabatt	the discount
die Leiter	the ladder
der Dschungel	the jungle
die Migration	the migration
die Atmung	the breathing
der Hurricane	the hurricane
der Einzelhändler	the retailer
der Coup	the coup
der Botschafter	the ambassador
die Dichte	the density
die Neugier	the curiosity
die Aggression	the aggression
der Reiz	the stimulus
der Journalismus	the journalism
der Roboter	the robot
die Feder	the feather
die Sphäre	the sphere
die Werbung	the publicity
der Bürgermeister	the major
das Wohlergehen	the well-being
die Gültigkeit	the validity
das Ökosystem	the ecosystem
der Kragen	the collar
das Gras	the weed
die Einhaltung	the compliance
der Streifen	the streak
der Bauarbeiter	the builder
die Voraussetzung	the premise
die Spezialität	the specialty
das Artefakt	the artifact
der Affe	the monkey
der Mentor	the mentor
der Zuhörer	the listener
der Blitz	the lightning
der Ärmel	the sleeve
die Enttäuschung	the disappointment
die Rippe	the rib
die Trümmer	the debris
die Stange	the rod
die liberale	the liberal
die Asche	the ash
die Pfarrei	the parish
die Sklaverei	the slavery
die Ware	the commodity
die Heilung	the cure
das Mineral	the mineral
der Hunger	the hunger
die Gleichheit	the equality
der Friedhof	the cemetery
die Belästigung	the harassment
die Berühmtheit	the fame
die Wahrscheinlichkeit	the likelihood
die Karotte	the carrot
die Maut	the toll
der Rand	the rim
der Rollstuhl	the wheelchair
der Prozessor	the processor
der Sponsor	the sponsor
das Grinsen	the grin
die Kälte	the chill
die Zuflucht	the refuge
der Gesetzgeber	the legislator
die Rallye	the rally
die Programmierung	the programming
der Abfluss	the outlet
der Verkäufer	the vendor
die Erdnuss	the peanut
der Intellektuelle	the intellectual
die Konzeption	the conception
die Auktion	the auction
das Steak	the steak
der Triumph	the triumph
der Aktionär	the shareholder
das Gewissen	the conscience
die Berechnung	the calculation
das Intervall	the interval
die Zuständigkeit	the jurisdiction
die Einschränkung	the constraint
die Expedition	the expedition
die Ähnlichkeit	the similarity
der Hintern	the butt
der Deckel	the lid
der Großteil	the bulk
die Sterblichkeit	the mortality
die Umwandlung	the conversion
der Patron	the patron
die Leber	the liver
die Harmonie	the harmony
die Toleranz	the tolerance
der Moment	the instant
die Ziege	the goat
der Segen	the blessing
die Banane	the banana
das Laufen	the running
der Palast	the palace
der Bauer	the peasant
der Supermarkt	the supermarket
die Kreuzfahrt	the cruise
die Ebene	the plain
der Kalender	the calendar
die Witwe	the widow
die Anzahlung	the deposit
der Bart	the beard
die Bremse	the brake
das Screening	the screening
der Impuls	the impulse
das Fell	the fur
der Räuber	the predator
das Forum	the forum
das Tanzen	the dancing
die Beseitigung	the removal
die Autonomie	the autonomy
der Faden	the thread
das Wahrzeichen	the landmark
der Täter	the offender
der Tourismus	the tourism
der Grenzbereich	the threshold
die Suite	the suite
der Regler	the regulator
der Strohhalm	the straw
der Globus	the globe
der Einwand	the objection
die Chemie	the chemistry
die Explosion	the blast
die Verweigerung	the denial
die Miete	the rental
das Fragment	the fragment
die Wärme	the warmth
die Bachelor	the undergraduate
die Kopfschmerzen	the headache
der Polizist	the policeman
die Ausbeute	the yield
der Vorsprung	the projection
die Erwähnung	the mention
der Schulabschluss	the graduation
die Villa	the mansion
der Bezug	the regard
die Traube	the grape
die Hütte	the cottage
die Auffahrt	the driveway
der Charm	the charm
die Sexualität	the sexuality
der Ton	the clay
der Ballon	the balloon
die Erfindung	the invention
das Ego	the ego
der Fahrpreis	the fare
die Hausaufgabe	the homework
das Sofa	the sofa
die Garantie	the guarantee
die Verfügbarkeit	the availability
das Radar	the radar
das Verlassen	the leave
die Genehmigung	the permit
der Pullover	the sweater
die Rehabilitation	the rehabilitation
der Rückzug	the retreat
das Molekül	the molecule
der Youngster	the youngster
das Bessere	the premium
die Rechenschaftspflicht	the accountability
die Müdigkeit	the fatigue
der Marker	the marker
der Eimer	the bucket
das Geständnis	the confession
der Marmor	the marble
die Verwindung	the twist
der Verteidiger	the defender
der Transport	the transport
die Überwachung	the surveillance
der Techniker	the technician
der Pfeil	the arrow
das Trauma	the trauma
das Farbband	the ribbon
die Zwischenzeit	the meantime
die Ernte	the harvest
der Spion	the spy
der Schlitz	the slot
der Aufstand	the riot
der Nährstoff	the nutrient
die Staatsbürgerschaft	the citizenship
die Souveränität	the sovereignty
der Grat	the ridge
die Beleuchtung	the lighting
der Beiträger	the contributor
der Transit	the transit
das Seminar	the seminar
die Elektronik	the electronics
die Shorts	the shorts
der Vorwurf	the accusation
der Cue	the cue
die Braut	the bride
die Biographie	the biography
die Gefahr	the hazard
die Fliese	the tile
der Ausländer	the foreigner
der Start	the launch
die Annehmlichkeit	the convenience
das Holz	the timber
der Klagegrund	the plea
die Glühbirne	the bulb
der Teufel	the devil
die Fracht	the cargo
die Wirbelsäule	the spine
der Verkäufer	the seller
das Dock	the dock
der Nebel	the fog
der Diplomat	the diplomat
die Zusammenfassung	the summary
der Missionar	the missionary
die Epidemie	the epidemic
das Warenhaus	the warehouse
der Schmetterling	the butterfly
die Bronze	the bronze
das Lob	the praise
das Vakuum	the vacuum
das Klischee	the stereotype
der Sensor	the sensor
die Wäscherei	the laundry
das Handbuch	the manual
die Pistole	the pistol
der Kläger	the plaintiff
die Mittelklasse	the middle-class
die Entschuldigung	the apology
der Man	the man
das Ding	the thing
die Raum	the room
die Ehefrau	the wife
das Los	the lot
die Anzahl	the number
der Beutel	the bag
die Rast	the rest
die Mama	the mom
die Sir	the sir
der Brief	the letter
die Wohnung	the apartment
der Fels	the rock
die Kleider	the clothes
das Gedächtnis	the memory
die Reiß	the tear
der Schüler	the student
die Sehenswürdigkeit	the sight
der Erzähler	the narrator
der Offizier	the officer
der Wächter	the guard
die Bit	the bit
der Fehl	the miss
das College	the college
das Geräusch	the noise
die Mama	the mama
der Herr	the lord
der Papa	the daddy
der Platz	the spot
das Maximum	the maximum
die Gate	the gate
die Vorhalle	the porch
das Schwimmbecken	the pool
die Bob	the bob
der Club	the club
die Türöffnung	the doorway
die Hose	the pant
das Erlebnis	the experience
das Camp	the camp
der Strahl	the ray
die Volks	the folk
der Knopf	the button
das Level	the level
die Runden	the lap
das Magazin	the magazine
der Ast	the branch
das Auf Wiedersehen	the goodbye
das Park	the parking
das Gelächter	the laughter
der Verfasser	the writer
die Gardine	the curtain
das Rudel	the pack
die Lilie	the lily
die Lauf	the run
das Weinen	the cry
die Instant	the instant
das Publikum	the audience
die Jahreszeit	the season
der Klient	the client
der Prinz	the prince
die Emotion	the emotion
der Grad	the degree
das Begräbnis	the funeral
der Oberschenkel	the thigh
der Buck	the buck
die Ziegel	the brick
die Hülse	the sleeve
der Speisesaal	the dining
der Drache	the dragon
der Umschlag	the envelope
die Erwachsene	the adult
das Kopfnicken	the nod
die Robe	the robe
der Stil	the style
die Kreis	the county
der Schrei	the scream
die Bitch	the bitch
der Seufzer	the sigh
der Messestand	the booth
das TShirt	the tshirt
das Flüstern	the whisper
die Hank	the hank
das Glied	the limb
der Bastard	the bastard
das Rotkehlchen	the robin
die Justiz	the justice
der Sekretär	the secretary
der Sheriff	the sheriff
die Mitternachts	the midnight
die Kiefer	the pine
die Papa	the papa
die Perle	the pearl
die Prinzessin	the princess
das Getriebe	the gear
der Koffer	the suitcase
das Atem	the breathing
der Gefangene	the prisoner
die Burg	the castle
die Fahrspur	the lane
der Hase	the rabbit
der Bereich	the range
die Dick	the dick
die Reflexion	the reflection
die Baseball	the baseball
der Schrecken	the terror
die Buster	the buster
der Wachtmeister	the sergeant
die Bedrohung	the threat
das Messgerät	the meter
der Umstand	the circumstance
der Sieger	the victor
die Oma	the grandma
das Glühen	the glow
die Slave	the slave
der Leutnant	the lieutenant
der Maurer	the mason
das Gehen	the walking
die Leiche	the corpse
das Pad	the pad
der Rubin	the ruby
der Oberst	the colonel
der Bach	the creek
die Gunst	the favor
der Dekan	the dean
der Marsch	the march
der Ständige	the standing
der Dämon	the demon
der Pinsel	the brush
die Haube	the hood
der Heilige	the saint
die Angel	the fishing
der Graf	the earl
der Kellner	the waiter
das Volumen	the volume
das Ass	the ace
die Phantasie	the imagination
die Schwarze	the black
der Reed	the reed
der Wanderer	the walker
der Ansatz	the approach
die Narbe	the scar
die Tritt	the footstep
der Aufnehmer	the pickup
der Habicht	the hawk
der Anhänger	the trailer
der Käfer	the bug
der Urheberrechts	the copyright
die China	the china
die Durchschnitts	the mean
die Druck	the print
der Idiot	the idiot
der Bulle	the bull
die Saat	the seed
das Versagen	the failure
die Taschenlampe	the flashlight
der Seemann	the sailor
das Weinen	the crying
die Sip	the sip
die Dämmerung	the dusk
das Makeup	the makeup
die Doc	the doc
die Bluse	the blouse
der Bolzen	the bolt
die Klopf	the knock
der Zauber	the spell
die Luke	the hatch
das Dienstmädchen	the maid
die Relative	the relative
die Hexe	the witch
die Locke	the curl
die Kellnerin	the waitress
der Hammer	the hammer
die Indische	the indian
der Balkon	the balcony
der Knoten	the knot
die Stare	the stare
das Motel	the motel
der Liebling	the darling
der Strang	the strand
die Mittags	the noon
die Vene	the vein
der Fuchs	the fox
die Impuls	the pulse
der Kies	the gravel
die Zigarre	the cigar
die Braune	the brown
der Schal	the scarf
die Klaue	the claw
der Cowboy	the cowboy
das Jagd	the hunting
das Pat	the pat
die Bildung	the education
der Schuppen	the shed
der Herzog	the duke
die Schrotflinte	the shotgun
die Wanne	the tub
die Iris	the iris
die Zugriffs	the access
die Seitenleiste	the sidebar
der Rumpf	the hull
die Lappen	the rag
das Gute	the good
der Gigant	the giant
die Serviette	the napkin
die Wäsche	the laundry
der Opa	the grandpa
die Einkaufshalle	the mall
der Ford	the ford
die Krähe	the crow
die Selbstmord	the suicide
der Sonnenuntergang	the sunset
der Donner	the thunder
der Whisky	the whiskey
der Klick	the click
der Müller	the miller
die Ruhe	the calm
der Deutsche	the german
der Mönch	the monk
der Wurm	the worm
die Traurigkeit	the sadness
die Tänzerin	the dancer
die Matratze	the mattress
die Ad	the ad
der Becher	the mug
das Kit	the kit
das Gebrüll	the roar
die Truppe	the troop
der Sarg	the coffin
der Krankenwagen	the ambulance
das Mondlicht	the moonlight
die Hosen	the trousers
die Wolle	the wool
die Mac	the mac
der Dieb	the thief
die Aktentasche	the briefcase
das Mitleid	the pity
die Finger	the fingertip
die Marine	the navy
das Gen	the gene
die Windschutzscheibe	the windshield
der Shuttle	the shuttle
das Unkraut	the weed
die Pfote	the paw
die Festung	the fort
das Plakat	the poster
der Vampir	the vampire
das Arschloch	the asshole
der Gurt	the strap
das Wohnzimmer	the parlor
die Falte	the fold
das Maß	the measure
der Ritter	the knight
der Brunnen	the fountain
der Stall	the stall
der Funke	the spark
der Champagner	the champagne
das Violett	the violet
das Trink	the drinking
das Taschentuch	the handkerchief
das Parfüm	the perfume
der Anspruch	the claim
die Nonne	the nun
die Krone	the crown
das Geländer	the railing
die Barmherzigkeit	the mercy
das Schließfach	the locker
die Burst	the burst
der Frosch	the frog
der Jeep	the jeep
der Bogenschütze	the archer
der Hirte	the shepherd
die Madame	the madame
der Schrott	the scrap
der Wulst	the bead
die Blendung	the glare
das Cafe	the cafe
das Pochen	the pounding
die Schlucht	the canyon
die Spinne	the spider
der Fluch	the curse
das Treppenhaus	the staircase
der Drang	the urge
die Sirene	the siren
das Leer	the curb
der Pirat	the pirate
der Liebe	the dear
die Politik	the politics
der Tennis	the tennis
die Zugehörigkeit	the affiliation
das Momma	the momma
der Umhang	the cape
der Scheinwerfer	the headlight
die Sauerstoff	the oxygen
der Fingernagel	the fingernail
der Weinstock	the vine
der Barkeeper	the bartender
der Koks	the coke
der Rabbi	the rabbi
die Begrüßung	the greeting
die Homer	the homer
der Kamin	the fireplace
das Trikot	the jersey
die Pop	the pop
das Gasthaus	the inn
der Stellvertretende	the deputy
die Verzweiflung	the despair
die Jazz	the jazz
die Umarmung	the hug
die Pfeife	the whistle
das Tageslicht	the daylight
der Slip	the slip
die Rüstung	the armor
der Rucksack	the backpack
das Nasenloch	the nostril
der Speer	the spear
das Kalb	the calf
der Fund	the discovery
die Kraftstoff	the fuel
die Unterwäsche	the underwear
die Kuppel	the dome
die Neigung	the affection
das Wohnzimmer	the lounge
die Achselzucken	the shrug
die Kohlen	the coal
die Jagd	the chase
der Klumpen	the lump
die Zahlung	the pay
die UBahn	the subway
die Kirsche	the cherry
die Eile	the hurry
die Geliebte	the mistress
der Unsinn	the nonsense
das Echo	the echo
der Durchhang	the slack
die Decker	the decker
der Toast	the toast
der Schnurrbart	the mustache
das Augenlid	the eyelid
die Chunk	the chunk
die Schildkröte	the turtle
die Gummi	the gum
der Prediger	the preacher
der Dolly	the dolly
das Leinen	the linen
der Heap	the heap
die Schürze	the apron
das Graue	the gray
der Ekel	the disgust
die Flotte	the liquor
der Lippenstift	the lipstick
der Container	the container
die Hure	the whore
das Kleinkind	the infant
die Sonnenbrille	the sunglasses
der Schlauch	the hose
das Bullshit	the bullshit
das Fach	the compartment
der Backofen	the oven
das Korn	the grain
das Picknick	the picnic
die Knospe	the bud
die Wiese	the meadow
das Gift	the poison
der Büffel	the buffalo
die Soda	the soda
die Eule	the owl
der Kick	the kick
die Ruine	the ruin
die Rampe	the ramp
der Achsschenkel	the knuckle
die Gans	the goose
der Vormarsch	the advance
die Fee	the fairy
die Mannschaft	the squad
die Orgel	the organ
der Unglaube	the disbelief
der Hain	the grove
der Sattel	the saddle
die Cluster	the cluster
der Abzug	the trigger
der Welpe	the puppy
die Warte	the waiting
die Kommode	the dresser
der Adler	the eagle
der Privatsphäre	the privacy
das Fluid	the fluid
die Herde	the herd
der Kopfschmerz	the headache
der Vergnügungspark	the amusement
das Belle	the belle
die Tabak	the tobacco
die Tätowierung	the tattoo
der Fleck	the stain
der Regenschirm	the umbrella
der Kaiser	the emperor
der Pier	the pier
der Wasserhahn	the tap
der Cutter	the cutter
der Dachboden	the attic
der Tiger	the tiger
die Pal	the pal
der Vorfahr	the ancestor
die Leiste	the ledge
die Fackel	the torch
die Tinten	the ink
das Maultier	the mule
das Stirnrunzeln	the frown
die Mitten	the midst
die Verlegenheit	the embarrassment
das Spannfutter	the chuck
die Clearing	the clearing
die Halskette	the necklace
die Laterne	the lantern
das Lamm	the lamb
die Schritt	the stride
die Manschette	the cuff
die Jungfrau	the virgin
das Eichhörnchen	the squirrel
der Star	the starling
das Speicher	the storage
der Altar	the altar
die Bogen	the arc
das Juwel	the jewel
die Junk	the junk
der Sonnenschein	the sunshine
der Knabe	the lad
der Elf	the elf
das Aspekt	the aspect
das Zifferblatt	the dial
der Hausschuh	the slipper
der Ohrring	the earring
die Ameise	the ant
die Patty	the patty
die Sauce	the sauce
der Graben	the ditch
das Gänseblümchen	the daisy
die Kapelle	the chapel
der Sumpf	the swamp
die Vermutung	the guess
der Kran	the crane
das Diner	the diner
das Skelett	the skeleton
das Elend	the misery
der Stumpf	the stump
der Einsatz	the stake
die Puff	the puff
das Gefolge	the wake
der Zauberer	the wizard
die Matte	the mat
das Zwielicht	the twilight
das Grunzen	the grunt
der Clan	the clan
das Kupfer	the copper
das Steuer	the steering
das Bedauern	the regret
die Romantik	the romance
die Terrasse	the patio
die Schaufel	the shovel
die Schlafanzüge	the pajamas
die Email	the email
die Taube	the pigeon
der Dinosaurier	the dinosaur
der Lift	the lift
das Küken	the chick
das Diagramm	the chart
der Lorbeer	the laurel
der Bluterguss	the bruise
der Knopf	the knob
der Frost	the frost
der Nippel	the nipple
der Pfarrer	the reverend
die Trübung	the haze
das Weihnachtslied	the carol
der Metzger	the butcher
der Würfel	the cube
der Hohl	the hollow
der Höcker	the bump
das Heu	the hay
die Rinde	the bark
die Überlebens	the survival
die Etagen	the bunk
die Biegung	the bend
der Cocktail	the cocktail
das Paradies	the paradise
das Rasiermesser	the razor
die Blüte	the blossom
die Pfütze	the puddle
die Laser	the laser
der Zement	the cement
die Gelbe	the amber
die Göttin	the goddess
die Drift	the drift
die Kämpfe	the fighting
das Geflecht	the braid
der Clown	the clown
die Brille	the goggle
der Pfirsich	the peach
die Wasch	the wash
die Befreiung	the release
die Tag	the tag
der Bh	the bra
die Terrasse	the terrace
die Überbleibsel	the remains
der Joint	the joint
der Diplom	the graduate
der Chor	the chorus
die Rache	the revenge
der Platz	the plaza
der Ältere	the elder
der Ingwer	the ginger
der Bindestrich	the dash
die Sandale	the sandal
der Hass	the hatred
der Umriss	the outline
der Rabe	the raven
die Vorfreude	the anticipation
die Qual	the agony
die Turnschuhe	the sneakers
das Terminal	the terminal
die Weide	the pasture
die Konsole	the console
das Abzeichen	the badge
der Fonds	the fund
das Foyer	the foyer
der Pastor	the pastor
die Umarmung	the embrace
der Applaus	the applause
der Graben	the trench
die Bis	the up
der Neffe	the nephew
der Mix	the mix
der Mob	the mob
die Güte	the goodness
der Scout	the scout
die Beihilfen	the aid
das Mikrofon	the microphone
der Kojote	the coyote
der Brennvorgang	the burn
die Weste	the vest
das Pony	the pony
das Keuchen	the gasp
das Zögern	the hesitation
die Taverne	the tavern
die Lästige Pflicht	the chore
das Segel	the sail
die Silhouette	the silhouette
das Institut	the institute
der Lügner	the liar
das Brett	the plank
der Ruck	the jerk
der Strumpf	the stocking
die Schwärze	the blackness
das Armband	the bracelet
der Beton	the concrete
das Banner	the banner
die Haltung	the posture
der Wodka	the vodka
die Bekanntschaft	the acquaintance
der Nap	the nap
der Schleier	the veil
das Schauspiel	the spectacle
die Kopfhaut	the scalp
die Stechpalme	the holly
der Appetit	the appetite
der Efeu	the ivy
die Nichte	the niece
die Verrücktheit	the madness
der Bäcker	the baker
das Virus	the virus
der Ordner	the folder
das Bekenntnis	the confession
der Gepäckträger	the porter
die Müllhalde	the dump
der Tratsch	the gossip
die Stute	the mare
der Rumpf	the torso
der Besen	the broom
der Huf	the hoof
der Speck	the bacon
das Heck	the stern
die Geige	the violin
die Pest	the plague
die Unschärfe	the blur
der Diakon	the deacon
die Lanze	the lance
der Gin	the gin
die Weide	the willow
die Kratz	the scratch
der Verband	the dressing
der Admiral	the admiral
der Regenbogen	the rainbow
die Eidechse	the lizard
der Zwerg	the dwarf
der Vers	the verse
die Überzeugung	the conviction
der Rover	the rover
der Zaunkönig	the wren
die Säulen	the pillar
die Marmelade	the jam
der Schnaps	the brandy
der Baron	the baron
die Wendung	the twist
die Skizze	the sketch
das Register	the register
der Herzschlag	the heartbeat
die Cafeteria	the cafeteria
die Hang	the hillside
das Labyrinth	the maze
das Brummen	the hum
das Kätzchen	the kitten
der Knall	the bang
der Dolch	the dagger
das Con	the con
die Einsamkeit	the loneliness
das Motorrad	the motorcycle
das Staunen	the amazement
die Peer	the peer
die Tech	the tech
die Beleidigung	the insult
die Ehrfurcht	the awe
die Chili	the chili
die Lodge	the lodge
die Limousine	the limo
die Mücke	the mosquito
der Würfel	the dice
der Shake	the shake
das Festmahl	the feast
die Erbse	the pea
das Murmeln	the murmur
der Genosse	the comrade
die Herde	the flock
das Zusammentreffen	the coincidence
der Waldläufer	the ranger
die Karikatur	the cartoon
der Mitbewohner	the roommate
die Freundlichkeit	the kindness
der Kreuzer	the cruiser
die Bramme	the slab
die Cheer	the cheer
der Konus	the cone
die Schaltung	the circuit
das Elfenbein	the ivory
der Zimmermann	the carpenter
der Penner	the bum
die Donna	the donna
die Krabbe	the crab
das Stöhnen	the groan
die Akademie	the academy
die Sehnsucht	the longing
die Kip	the kip
der Bohrer	the drill
das Gepäck	the luggage
der Baldachin	the canopy
der Nervenkitzel	the thrill
der Sumpf	the marsh
der Schornstein	the chimney
die Anker	the anchor
das Ahorn	the maple
das Kaninchen	the bunny
der Thron	the throne
das Neon	the neon
die Luftschleuse	the airlock
die Ermüdungs	the fatigue
das Manuskript	the manuscript
das Denkmal	the memorial
das Engineering	the engineering
die Linke	the left
die Assoziation	the association
die Beute	the prey
die Taube	the dove
die Episode	the episode
die Kathedrale	the cathedral
die Nach Unten	the down
der Saum	the hem
die Lust	the lust
die Kichern	the giggle
die Klassenkameraden	the classmate
die Reinigung	the cleaning
der Rezeptionist	the receptionist
der Anrufer	the caller
die Verachtung	the contempt
die Großeltern	the grandparent
die Tat	the deed
die Falten	the wrinkle
der Magier	the magician
der Stich	the pang
die Italienische	the italian
die Ewigkeit	the eternity
der Schiefer	the slate
das Treppenhaus	the stairwell
die Vase	the vase
die Oma	the granny
der Außenseiter	the maverick
die Bandage	the bandage
der Schinken	the ham
der Fuhrmann	the carter
die Unschuld	the innocence
die Dach	the rooftop
der Pfannkuchen	the pancake
der Asteroid	the asteroid
die Postkarte	the postcard
das Kleidungsstück	the garment
die Bestimmung	the determination
der Traktor	the tractor
die Beere	the berry
der Klumpen	the clump
die Straftat	the offense
der Butler	the butler
der Husten	the cough
der Granit	the granite
der Wende	the turning
das Kompliment	the compliment
der Karton	the carton
die Türklingel	the doorbell
die Gewissheit	the certainty
die Dankbarkeit	the gratitude
die Jetzige	the current
das Dunkel	the gloom
der Putz	the plaster
die Chop	the chop
die Mordkommission	the homicide
die Aluminium	the aluminum
der Boulevard	the boulevard
der Schüler	the pupil
der Schwimmer	the float
der Schnittpunkt	the intersection
die Leere	the emptiness
der Verlag	the publisher
der Zirkus	the circus
die Abmessung	the dimension
der Tierpark	the zoo
der Bote	the messenger
das Beau	the beau
das Gewirr	the tangle
die Verzweiflung	the desperation
der Abfluss	the drain
die Erdbeere	the strawberry
das Fernglas	the binoculars
die Kluft	the gulf
die Hecke	the hedge
das Stöhnen	the moan
der Verschluss	the shutter
das Floß	the raft
der Arzt	the physician
das Kamel	the camel
das Schlagen	the beating
das Becken	the basin
das Nachthemd	the nightgown
das Cockpit	the cockpit
das Wrack	the wreck
die Perücke	the wig
der Recorder	the recorder
die Höflichkeit	the courtesy
die Wangenknochen	the cheekbone
die Peitsche	the whip
der Pilger	the pilgrim
der Weise	the sage
der Asphalt	the asphalt
die Süße	the sweetie
der Obstgarten	the orchard
das Kinderbett	the cot
der Beutel	the pouch
das Feuerzeug	the lighter
die Snack	the snack
das Reden	the talking
die Op	the op
die Welligkeit	the ripple
die Radar	the radar
der Pferdeschwanz	the ponytail
die Stoß	the surge
der Erbe	the heir
der Bunker	the vault
die Sissy	the sissy
die Schotten	the scotch
die Tunika	the tunic
der Think	the think
der Penis	the penis
der Einheimische	the native
das Liebesspiel	the lovemaking
die Poker	the poker
der Kalk	the lime
das Überwachungs	the surveillance
der Chopper	the chopper
der Träger	the carrier
das Kin	the kin
die Passform	the fit
die Pull	the pull
das Bauernhaus	the farmhouse
das Warten	the wait
der Attentäter	the assassin
der Schaum	the foam
der Schlepper	the tug
der Abstieg	the descent
das Klingeln	the ringing
die Schere	the scissors
der Zweig	the twig
der Urlaubsort	the resort
der Beschützer	the guardian
der Weizen	the wheat
der Hurrikan	the hurricane
der Spielplatz	the playground
die Tastatur	the keyboard
die Zeder	the cedar
das Wappen	the crest
der Jasmin	the jasmine
der Sessel	the armchair
die Schwalbe	the swallow
das Dreieck	the triangle
der Gestank	the stench
der Supervisor	the supervisor
die Weite	the expanse
das Moos	the moss
der Sturm	the gale
die Treue	the loyalty
der Lavendel	the lavender
die Begnadigung	the pardon
der Aschenbecher	the ashtray
die Scherbe	the shard
die Ablenkung	the distraction
die Majestät	the majesty
die Pyramide	the pyramid
der Ruhm	the fame
die Not	the distress
der Magier	the mage
der Schwarm	the crush
die Dime	the dime
die Böen	the gust
der Festlichkeit	the treat
der Schläger	the thug
die Steckdose	the socket
der Kürbis	the pumpkin
der Dorn	the thorn
die Wurst	the sausage
die Dig	the dig
der Tan	the tan
der Dorn	the spike
die Krume	the crumb
das Wachs	the wax
das Knurren	the growl
die Vermietung	the rental
das Futter	the feed
die Eskorte	the escort
das Erstaunen	the astonishment
die Flora	the flora
die Blüte	the bloom
das Loft	the loft
das Flimmern	the flicker
der Leibwächter	the bodyguard
die Umsetzung	the realization
der Krater	the crater
das Kongress	the congress
der Braten	the fry
das Zittern	the shiver
der Verlierer	the loser
die Zuzwinkern	the wink
die Kies	the pebble
der Sonnenaufgang	the sunrise
die Erschöpfung	the exhaustion
der Doppelgänger	the double
der Umfang	the perimeter
der Kamm	the comb
der Spritz	the splash
die Konvention	the convention
die Pose	the pose
die Wiege	the cradle
der Stößel	the ram
der Adel	the gentry
die Naht	the seam
der Punk	the punk
der Überrest	the remnant
der Cracker	the cracker
der Bluff	the bluff
die Düne	the dune
der Zahnarzt	the dentist
die Satin	the satin
das Postfach	the mailbox
der Ärger	the annoyance
das Zischen	the hiss
das Lokal	the local
der Bums	the thud
die Bestürzung	the dismay
der Freak	the freak
der Haarschnitt	the haircut
die Süße	the sweet
die Waise	the orphan
das Schach	the chess
die Blütenblatt	the petal
die Schreibarbeit	the paperwork
der Psychiater	the psychiatrist
der Gesang	the singing
das Interrupt	the interrupt
die Bewunderung	the admiration
das Gefrier	the freezer
die Illustration	the illustration
der Eintopf	the stew
der Ermittler	the investigator
der Vorort	the suburb
das Holster	the holster
die Intimität	the intimacy
die Peitsche	the lash
die Einsparung	the saving
die Henne	the hen
die Birke	the birch
der Kindergarten	the nursery
die Pflaume	the plum
das Nichts	the void
die Kanone	the cannon
die Fransen	the fringe
die Stereo	the stereo
die Fella	the fella
der Pinguin	the penguin
die Folter	the torture
die Briefmarke	the stamp
der Übersetzer	the translator
das Einfrieren	the freeze
die Pew	the pew
der Pfropfen	the wad
das Höschen	the panties
der Spieß	the spit
der Kühler	the cooler
der Grill	the grill
der Spitzname	the nickname
der Revolver	the revolver
die Maschinen	the machinery
die Damen Und Herren	the madam
der Hecht	the pike
der Laptop	the laptop
der Schnabel	the beak
die Geschwister	the sibling
der Kleiderschrank	the wardrobe
die Klappe	the flap
der Einzige	the sole
das Mitgefühl	the compassion
die Antennen	the antenna
die Grille	the cricket
der Troll	the troll
der Bücherladen	the bookstore
der Halter	the holder
die Unwissenheit	the ignorance
das Korps	the corps
die Einsamkeit	the solitude
die Chemische	the chemical
der Dorfbewohner	the villager
die Perfektion	the perfection
der Papst	the pope
das Semester	the semester
die Untertasse	the saucer
die Dringlichkeit	the urgency
der Vulkan	the volcano
die Würze	the spice
der Chor	the choir
der Boxer	the boxer
die Besorgung	the errand
wobei der Mechanismus	the mechanism
die Fähre	the ferry
der Nigger	the nigger
der Passant	the passerby
die Reizung	the irritation
die Limousine	the sedan
der Feigling	the coward
die Git	the git
die Fackel	the flare
das Heulen	the howl
die Fang	the fang
die Römisch	the roman
der Farbton	the hue
das Unbehagen	the discomfort
das Entlüftungs	the vent
das Kanu	the canoe
der Hamburger	the hamburger
die Traufe	the eave
der Barbier	the barber
das Ableben	the passing
der Verrat	the betrayal
das Sweatshirt	the sweatshirt
die Tentakel	the tentacle
die Brandung	the surf
das Plaid	the plaid
der Gehweg	the walkway
das Hinken	the limp
die Bequemlichkeit	the convenience
die Windel	the diaper
der Maulwurf	the mole
der Reiniger	the cleaner
die Dünung	the swell
der Erwachsene	the grownup
die Scan	the scan
die Klarheit	the clarity
der Salon	the salon
die Flug	the flying
der Rechtsmittelgrund	the plea
die Prärie	the prairie
die Eitelkeit	the vanity
die Olive	the olive
der Bergmann	the miner
die Sicherungs	the backup
die Gegensprechanlage	the intercom
das Tuch	the shawl
der Plattenteller	the platter
das Poltern	the rumble
der Ansager	the announcer
die Axt	the axe
die Übertragungs	the transmission
die Krippe	the crib
die Sprung	the hop
das Aroma	the aroma
die Walze	the roller
der Transfer	the transfer
der Generator	the generator
die Luxus	the luxury
das Auditorium	the auditorium
der Kobold	the goblin
der Zapfen	the peg
die Probe	the specimen
die Zulassung	the admission
die Besessenheit	the obsession
die Patsy	the patsy
das Wohnheim	the dorm
die Säge	the saw
die Til	the til
der Staffelungs	the stagger
die Fotze	the pussy
die Flocke	the flake
die Silbe	the syllable
das Bouquet	the bouquet
der Schwur	the vow
die Enkelin	the granddaughter
der Aufruhr	the riot
der Burger	the burger
die Plus	the plus
der Spatz	the sparrow
die Botschaft	the embassy
das Podium	the podium
das Herrenhaus	the manor
das Schlurfen	the shuffling
der Delfin	the dolphin
der Wasserkocher	the kettle
der Tierarzt	the vet
die Landebahn	the runway
der Mohn	the poppy
die Lava	the lava
der Busen	the bosom
der Eindringling	the intruder
der Pokal	the trophy
die Eifersucht	the jealousy
der Aufseher	the warden
der Yachthafen	the marina
das Lebewohl	the farewell
die Gegenstände	the belongings
die Prozession	the procession
der Astronaut	the astronaut
die Sweep	the sweep
die Erholung	the recovery
der Kabelbaum	the harness
das Logo	the logo
der Wurf	the litter
die Marine	the marine
der Groll	the resentment
der CoOp	the coop
der Zigeuner	the gypsy
die Nachahmung	the imitation
die Flöte	the flute
der Grieche	the greek
die Wohnung	the condo
der Zeigefinger	the forefinger
das Begräbnis	the burial
der Smaragd	the emerald
der Bademantel	the bathrobe
das Scharnier	the hinge
die Bäckerei	the bakery
das Schnäppchen	the bargain
das Sprichwort	the saying
der Vorarbeiter	the foreman
der Schwan	the swan
die Flanell	the flannel
der Käfer	the beetle
die Lern	the learning
das Lokal	the pub
die Fraktion	the fraction
die Forelle	the trout
die Kruste	the crust
die Überzugs	the overcoat
das Glitzern	the glint
das Willkommen	the welcome
das Wörterbuch	the dictionary
die Haupt	the main
der Anstieg	the climb
die Leine	the leash
