sein	be
und	and
zu	to
haben	have
es	it
ich	I
sie	you
er	he
mit	with
machen	do
sagen	say
sie	they
aber	but
wir	we
nicht	not
oder	or
wie	as
was	what
gehen	go
ihr	their
wer	who
bekommen	get
ob	if
würde	would
ihr	her
machen	make
über	about
kennen	know
werden	will
ein	one
die Zeit	the time
dort	there
das Jahr	the year
denken	think
wann	when
welche	which
etwas	something
mich	me
die Menschen	people
nehmen	take
aus	out
in	into
sehen	see
Ihre	your
kommen	come
jetzt	now
als	than
mögen	like
andere	other
dann	then
es ist	it is
unser	our
zwei	two
mehr	more
wollen	want
der Weg	the way
aussehen	look
zuerst	first
ebenfalls	also
neu	new
weil	because
der Tag	the day
benutzen	use
nein	no
der Mann	the man
finden	find
hier	here
die Sache	the thing
geben	give
viele	many
gut	well
nur	only
sagen	tell
sehr	very
sogar	even
zurück	back
irgendein	any
gut	good
die Frau	the woman
uns	us
das Leben	the life
das Kind	the child
arbeiten	work
nieder	down
nach	after
der Anruf	the call
anrufen	to call
die Welt	the world
über	over
die Schule	the school
immer noch	still
versuchen	try
letzte	last
fragen	ask
brauchen	need
auch	too
das Gefühl	the feeling
drei	three
der Staat	the state
noch nie	never
werden	become
zwischen	between
hoch	high
wirklich	really
etwas	something
die meisten	most
ein weiterer	another
viel	much
die Familie	the family
besitzen	own
verlassen	leave
stellen	put
alt	old
während	while
bedeuten	mean
behalten	keep
der Student	the student
warum	why
lassen	let
groß	great
gleich	same
groß	big
die Gruppe	the group
start	begin
scheinen	seem
das Land	the country
hilfe	to help
sich unterhalten	talk
woher	where
wende	turn
das Problem	the problem
jeden	every
anfang	start
die Hand	the hand
macht	might
amerikanisch	American
show	show
der Teil	the part
gegen	against
der Ort	the place
eine solche	such
nochmal	again
wenige	few
der Fall	the case
die Woche	the week
das Unternehmen	the company
das System	the system
jeder	each
recht	right
das Programm	the program
hören	hear
die Frage	the question
während	during
die Arbeit	the work
abspielen	play
die Regierung	the government
lauf	run
klein	small
die Nummer	the number
immer	always
bewegung	move
die Nacht	the night
leben	live
der Herr	the Mr
die Stelle	the point
glauben	believe
halt	hold
heute	today
bringen	bring
geschehen	happen
nächster	next
ohne	without
vor	before
die million	million
muss	must
das Zuhause	the home
unter	under
das Wasser	the water
das Zimmer	the room
schreiben	write
die Mutter	the mother
das Gebiet	the area
national	national
das Geld	the money
die Geschichte	the story
jung	young
die Tatsache	the fact
der Monat	the month
anders	different
das Ganze	the lot
das Recht	the right
die Studium	the study
das Buch	the book
das Auge	the eye
die Arbeit	the job
das Wort	the word
obwohl	though
das Geschäft	the business
das Thema	the issue
die Seite	the side
die Art	the kind
vier	four
der Kopf	the head
weit	far
schwarz	black
lange	long
beide	both
wenig	little
das Haus	the house
ja	yes
schon seit	since
zu Verfügung stellen	provide
der Service	the service
um	around
der Freund	the friend
wichtig	important
der Vater	the father
sitzen	sit
weg	away
bis	until
die Macht	the power
die Stunde	the hour
das Spiel	the game
häufig	often
noch	yet
die Linie	the line
politisch	political
das Ende	the end
unter	among
je	ever
stand	stand
schlecht	bad
verlieren	lose
jedoch	however
das Mitglied	the member
zahlen	pay
das Gesetz	the law
treffen	meet
das Auto	the car
die Stadt	the city
fast	almost
einschließen	include
fortsetzen	continue
einstellen	set
später	later
die Gemeinde	the community
der Name	the name
fünf	five
einmal	once
weiß	white
am wenigsten	at least
der Präsident	the president
lernen	learn
echt	real
veränderung	change
das Team	the team
die Minute	the minute
beste	best
mehrere	several
die Idee	the idea
das Kind	the kid
der Körper	the body
die Information	the information
nichts	nothing
vor	ago
führen	lead
sozial	social
verstehen	understand
ob	whether
der Rücken	the back
uhr	watch
zusammen	together
folgen	follow
das Elternteil	the parent
halt	stop
das Gesicht	the face
erstellen	create
Öffentlichkeit	public
bereits	already
sprechen	speak
die Anderen	the others
lesen	read
die Ebene	the level
ermöglichen	allow
hinzufügen	add
das Büro	the office
verbringen	spend
die Tür	the door
die Gesundheit	the health
die Person	the person
die Kunst	the art
sicher	sure
der Krieg	the war
die Geschichte	the history
die Party	the party
innerhalb	within
wachsen	grow
das Ergebnis	the result
öffnen	open
der Wechsel	the change
der Morgen	the morning
gehen	walk
der Grund	the reason
niedrig	low
sieg	win
die Forschung	the research
das Mädchen	the girl
der Kerl	the guy
früh	early
das Essen	the food
der Moment	the moment
selbst	himself
die Luft	the air
der Lehrer	the teacher
die Kraft	the force
das Angebot	the offer
genug	enough
die Erziehung	the education
obwohl	although
merken	remember
der Fuß	the foot
zweite	second
der Junge	the boy
fähig	able
das Alter	the age
die Richtlinie	the policy
alles	everything
liebe	love
der Prozess	the process
die Musik	the music
einschließlich	including
erwägen	consider
erscheinen	appear
tatsächlich	actually
kaufen	buy
wahrscheinlich	probably
Mensch	human
warten	wait
dienen	serve
der Markt	the market
sterben	die
senden	send
Zuhause	home
der Sinn	the sense
bauen	build
bleibe	stay
fallen	fall
die Nation	the nation
der Plan	the plan
schnitt	cut
die Hochschule	the college
die Interesse	the interest
der Tod	the death
kurs	course
jemand	someone
die Erfahrung	the experience
hinter	behind
erreichen	reach
lokal	local
töten	kill
sechs	six
bleiben übrig	remain
der Effekt	the effect
die Verwendung	the use
ja	yeah
vorschlagen	suggest
die Klasse	the class
die Kontrolle	the control
erziehen	raise
die Pflege	the care
vielleicht	perhaps
spät	late
hart	hard
das Feld	the field
sonst	else
bestehen	pass
ehemalige	former
verkaufen	sell
haupt	major
manchmal	sometimes
benötigen	require
eine lange	along
die Entwicklung	the development
sich	themselves
Bericht	report
die Rolle	the role
besser	better
wirtschaftlich	economic
der Aufwand	the effort
entscheiden	decide
die Rate	the rate
stark	strong
möglich	possible
das Herz	the heart
das Medikament	the drug
die Show	the show
der Leiter	the leader
das Licht	the light
die Stimme	the voice
die Frau	the wife
ganze	whole
die Polizei	the police
der Verstand	the mind
endlich	finally
ziehen	pull
rückkehr	return
frei	free
der Preis	the price
der Bericht	the report
weniger	less
gemäß	according
die Entscheidung	the decision
erklären	explain
der Sohn	the son
Hoffnung	hope
entwickeln	develop
die Aussicht	the view
die Beziehung	the relationship
tragen	carry
die Stadt	the town
die Straße	the road
fahrt	drive
der Arm	the arm
bundes	federal
unterbrechung	break
der Unterschied	the difference
danken	thank
erhalten	receive
der Wert	the value
international	international
das Gebäude	the building
die Aktion	the action
voll	full
das Model	the model
beitreten	join
die Saison	the season
die Gesellschaft	the society
die Steuer	the tax
der Direktor	the director
die Position	the position
der Spieler	the player
zustimmen	agree
insbesondere	especially
der Datensatz	the record
pflücken	pick
tragen	wear
das Papier	the paper
besondere	special
der Raum	the space
der Boden	the ground
die Form	the form
unterstützung	support
das Ereignis	the event
das offizielle	the official
deren	whose
der Grund	the matter
jeder	everyone
das Zentrum	the center
das Ehepaar	the couple
der Standort	the site
Ende	end
das Projekt	the project
schlagen	hit
Base	base
die Aktivität	the activity
der Stern	the star
der Tisch	the table
das Bedürfnis	the need
das Gericht	the court
produzieren	produce
essen	eat
die Amerikaner	the American
lehren	teach
das Öl	the oil
Hälfte	half
die Situation	the situation
einfach	easy
die Kosten	the cost
die Branche	the industry
die Figur	the figure
Gesicht	face
die Straße	the street
das Bild	the image
selbst	itself
das Telefon	the phone
entweder	either
die Daten	the data
abdeckung	cover
ganz	quite
das Bild	the picture
klar	clear
die Übung	the practice
das Stück	the piece
das Land	the land
kürzlich	recent
beschreiben	describe
das Produkt	the product
der Doktor	the doctor
die Mauer	the wall
der Patient	the patient
der Arbeiter	the worker
die Nachrichten	the news
der Test	the test
der Film	the movie
sicher	certain
der Norden	the north
die Liebe	the love
persönlich	personal
die Unterstützung	the support
einfach	simply
dritte	third
die Technologie	the technology
fang	catch
der Schritt	the step
das Baby	the baby
der Computer	the computer
der Typ	the type
die Aufmerksamkeit	the attention
zeichnen	draw
der Film	the film
die Republikaner	the Republican
der Baum	the tree
die Quelle	the source
rot	red
fast	nearly
die Organisation	the organization
wählen	choose
Ursache	cause
das Haar	the hair
das Aussehen	the look
Punkt	point
das Jahrhundert	the century
der Beweis	the evidence
das Fenster	the window
schwer	difficult
Hör mal zu	listen
bald	soon
die Kultur	the culture
Milliarde	billion
die Chance	the chance
der Bruder	the brother
die Energie	the energy
die Periode	the period
der Kurs	the course
der Sommer	the summer
realisieren	realize
hundert	hundred
verfügbar	available
die Pflanze	the plant
wahrscheinlich	likely
die Gelegenheit	the opportunity
der Begriff	the term
kurz	short
der Buchstabe	the letter
die Bedingung	the condition
die Wahl	the choice
Ort	place
single	single
die Regel	the rule
die Tochter	the daughter
die Verwaltung	the administration
der Süden	the south
der Ehemann	the husband
der Kongress	the Congress
der Boden	the floor
die Kampagne	the campaign
das Material	the material
die Bevölkerung	the population
der Anruf	the call
die Wirtschaft	the economy
medizinisch	medical
das Krankenhaus	the hospital
die Kirche	the church
schließen	close
tausend	thousand
das Risiko	the risk
Strom	current
das Feuer	the fire
die Zukunft	the future
falsch	wrong
betreffen	involve
die Verteidigung	the defense
jemand	anyone
die Sicherheit	the security
die Bank	the bank
mich selber	myself
bestimmt	certainly
der Westen	the west
der Sport	the sport
die Tafel	the board
suchen	seek
pro	per
das Thema	the subject
der Beamte	the officer
privatgelände	private
der Rest	the rest
das Verhalten	the behavior
Deal	deal
die Performance	the performance
Kampf	fight
werfen	throw
die Spitze	the top
schnell	quickly
vergangenheit	past
das Ziel	the goal
der Zweite	the second
das Bett	the bed
die Bestellung	the order
der Autor	the author
füllen	fill
vertreten	represent
Fokus	focus
fremd	foreign
fallen	drop
planen	plan
das Blut	the blood
die Agentur	the agency
drücken	push
die Natur	the nature
die Farbe	the color
vor kurzem	recently
das Geschäft	the store
reduzieren	reduce
der Klang	the sound
Hinweis	note
fein	fine
in der Nähe von	near
die Bewegung	the movement
die Seite	the page
eingeben	enter
aktie	share
verbreitet	common
arm	poor
natürlich	natural
das Rennen	the race
die Sorge	the concern
die Serie	the series
von Bedeutung	significant
ähnlich	similar
heiß	hot
die Sprache	the language
gewöhnlich	usually
die Antwort	the response
tot	dead
erhebt euch	rise
das Tier	the animal
der Faktor	the factor
das Jahrzehnt	the decade
der Artikel	the article
schießen	shoot
der Osten	the east
sparen	save
sieben	seven
der Künstler	the artist
die Szene	the scene
die Aktie	the stock
die Karriere	the career
trotz	despite
zentral	central
acht	eight
so	thus
die Behandlung	the treatment
darüber hinaus	beyond
glücklich	happy
genau	exactly
schützen	protect
die Vorgehensweise	the approach
lüge	lie
die Größe	the size
der Hund	the dog
die Kaution	the fund
ernst	serious
auftreten	occur
die Medien	the media
bereit	ready
das Schild	the sign
der Gedanke	the thought
die Liste	the list
der Einzelne	the individual
die Qualität	the quality
der Druck	the pressure
akzeptieren	accept
die Antwort	the answer
die Ressource	the resource
identifizieren	identify
links	left
das Treffen	the meeting
bestimmen	determine
bereiten	prepare
die Krankheit	the disease
was auch immer	whatever
der Erfolg	the success
streiten	argue
die Tasse	the cup
insbesondere	particularly
die Summe	the amount
die Fähigkeit	the ability
das Personal	the staff
erkenne	recognize
zeigen	indicate
der Charakter	the character
das Wachstum	the growth
der Verlust	the loss
das Grad	the degree
sich wunder	wonder
der Angriff	the attack
sie selber	herself
die Region	the region
das Fernsehen	the television
die Kiste	the box
der Fernseher	the TV
das Training	the training
ziemlich	pretty
der Handel	the trade
der Deal	the deal
die Wahl	the election
physikalisch	physical
legen	lay
allgemeines	general
das Gefühl	the feeling
der Standard	the standard
die Rechnung	the bill
die Nachricht	the message
scheitern	fail
draußen	outside
ankommen	arrive
die Analyse	the analysis
der Vorteil	the benefit
name	name
das Geschlecht	the sex
nach vorne	forward
der Rechtsanwalt	the lawyer
geschenk	present
die Sektion	the section
umwelt	environmental
das Glas	the glass
antworten	answer
das Können	the skill
die Schwester	the sister
der Professor	the professor
die Operation	the operation
finanz	financial
das Verbrechen	the crime
die Bühne	the stage
vergleichen	compare
die Autorität	the authority
die Fräulein	the miss
das Design	the design
die Art	the sort
der Eine	the one
handlung	act
zehn	ten
das Wissen	the knowledge
die Waffe	the gun
der Bahnhof	the station
blau	blue
Zustand	state
die Strategie	the strategy
deutlich	clearly
diskutieren	discuss
tatsächlich	indeed
Macht	force
die Wahrheit	the truth
das Lied	the song
das Beispiel	the example
demokratisch	democratic
prüfen	check
die Umgebung	the environment
das Bein	the leg
dunkel	dark
die Öffentlichkeit	the public
verschiedene	various
lieber	rather
Lachen	laugh
vermuten	guess
die Exekutive	the executive
der Satz	the set
Studie	study
beweisen	prove
aufhängen	hang
ganz	entire
der Stein	the rock
Design	design
vergessen	forget
anspruch	claim
die Notiz	the note
löschen	remove
der Geschäftsführer	the manager
die Hilfe	the help
klingen	sound
genießen	enjoy
das Netzwerk	the network
legal	legal
religiös	religious
kalt	cold
bilden	form
finale	final
main	main
die Wissenschaft	the science
grün	green
die Erinnerung	the memory
die Karte	the card
der Sitz	the seat
die Zelle	the cell
gründen	establish
nett	nice
die Studie	the trial
der Experte	the expert
der Frühling	the spring
die Firma	the firm
der Demokrat	the Democrat
das Radio	the radio
besuch	visit
das Management	the management
pflege	care
vermeiden	avoid
vorstellen	imagine
heute Abend	tonight
enorm	huge
der Ball	the ball
fertig	finish
dich selber	yourself
das Gespräch	the talk
die Theorie	the theory
der Aufprall	the impact
reagieren	respond
die Aussage	the statement
pflegen	maintain
die Ladung	the charge
beliebt	popular
traditionell	traditional
auf zu	onto
verraten	reveal
die Richtung	the direction
die Waffe	the weapon
der Arbeitnehmer	the employee
kultur	cultural
enthalten	contain
der Frieden	the peace
Kopf	head
Steuerung	control
die Basis	the base
der Schmerz	the pain
sich bewerben	apply
das Spiel	the play
die Maßnahme	the measure
breit	wide
shake	shake
fliege	fly
das Interview	the interview
verwalten	manage
der Stuhl	the chair
der Fisch	the fish
besonders	particular
die Kamera	the camera
die Struktur	the structure
die Politiker	the politics
ausführen	perform
das Bit	the bit
das Gewicht	the weight
plötzlich	suddenly
entdecken	discover
der Kandidat	the candidate
die Produktion	the production
behandeln	treat
die Reise	the trip
der Abend	the evening
beeinflussen	affect
innerhalb	inside
die Konferenz	the conference
die Einheit	the unit
der Style	the style
der erwachsene	the adult
sorge	worry
die Reichweite	the range
erwähnen	mention
tief	deep
die Vergangenheit	the past
die Kante	the edge
individuell	individual
spezifisch	specific
der Schriftsteller	the writer
die Schwierigkeiten	the trouble
notwendig	necessary
die Herausforderung	the challenge
die Angst	the fear
die Schulter	the shoulder
die Institution	the institution
Mitte	middle
das Meer	the sea
der Traum	the dream
die Bar	the bar
schön	beautiful
die Eigenschaft	the property
stattdessen	instead
verbessern	improve
das Zeug	the stuff
das Detail	the detail
die Methode	the method
Schild	sign
die Zeitschrift	the magazine
das Hotel	the hotel
der Soldat	the soldier
reflektieren	reflect
schwer	heavy
sexuell	sexual
die Ursache	the cause
die Tasche	the bag
die Hitze	the heat
der Herbst	the fall
die Ehe	the marriage
zäh	tough
singen	sing
die Oberfläche	the surface
die Absicht	the purpose
existieren	exist
das Muster	the pattern
wem	whom
die Haut	the skin
der Agent	the agent
der Besitzer	the owner
die Maschine	the machine
das Gas	the gas
voraus	ahead
die Generation	the generation
kommerziell	commercial
Adresse	address
der Krebs	the cancer
Prüfung	test
der Gegenstand	the item
die Realität	the reality
der Trainer	the coach
Schritt	step
der Hof	the yard
schlagen	beat
die Gewalt	the violence
gesamt	total
neigen	tend
die Investition	the investment
die Diskussion	the discussion
der Finger	the finger
der Garten	the garden
beachten	notice
die Sammlung	the collection
modern	modern
die Aufgabe	the task
der Partner	the partner
positiv	positive
bürgerlich	civil
die Küche	the kitchen
der Verbraucher	the consumer
der Schuss	the shot
das Budget	the budget
wunsch	wish
das Gemälde	the painting
der Wissenschaftler	the scientist
die Vereinbarung	the agreement
die Hauptstadt	the capital
der Mund	the mouth
noch	nor
das Opfer	the victim
die Zeitung	the newspaper
die Drohung	the threat
die Verantwortung	the responsibility
Lächeln	smile
der Anwalt	the attorney
die Punktzahl	the score
das Konto	the account
interessant	interesting
die Pause	the break
die Zuschauer	the audience
reich	rich
das Abendessen	the dinner
Zahl	figure
western	western
sich beziehen	relate
reise	travel
die Debatte	the debate
verhindern	prevent
der Bürger	the citizen
die Mehrheit	the majority
keiner	none
Vorderseite	front
geboren	born
eingestehen	admit
Senior	senior
annehmen	assume
der Wind	the wind
Schlüssel	key
professionel	professional
die Mission	the mission
schnell	fast
allein	alone
der Kunde	the customer
leiden	suffer
die Rede	the speech
erfolgreich	successful
die Option	the option
der Teilnehmer	the participant
süd	southern
frisch	fresh
schließlich	eventually
der Wald	the forest
das Video	the video
global	global
der Senat	the Senate
die Reform	the reform
der Zugang	the access
das Restaurant	the restaurant
der Richter	the judge
veröffentlichen	publish
Kosten	cost
die Beziehung	the relation
freisetzung	release
der Vogel	the bird
die Meinung	the opinion
der Kredit	the credit
kritisch	critical
die Ecke	the corner
besorgt	concerned
erinnern	recall
die Version	the version
starren	stare
die Sicherheit	the safety
wirksam	effective
die Nachbarschaft	the neighborhood
original	original
der Akt	the act
das Einkommen	the income
direkt	directly
verletzt	hurt
die Arten	the species
sofort	immediately
die Strecke	the track
basic	basic
streik	strike
die Hoffnung	the hope
der Himmel	the sky
die Freiheit	the freedom
absolut	absolutely
das Flugzeug	the plane
niemand	nobody
leisten	achieve
das Objekt	the object
die Attitüde	the attitude
verweisen	refer
das Konzept	the concept
der Kunde	the client
mächtig	powerful
perfekt	perfect
neun	nine
deshalb	therefore
verhalten	conduct
bekannt geben	announce
die Unterhaltung	the conversation
untersuchen	examine
berühren	touch
bitte	please
besuchen	attend
vollständig	completely
abstimmung	vote
die Vielfalt	the variety
schlaf	sleep
die Wende	the turn
beteiligt	involved
die Ermittlung	the investigation
nuklear	nuclear
der Forscher	the researcher
die Presse	the press
der Konflikt	the conflict
der Geist	the spirit
erfahrung	experience
ersetzen	replace
britisch	British
ermutigen	encourage
das Argument	the argument
das Lager	the camp
das Gehirn	the brain
das Merkmal	the feature
der Nachmittag	the afternoon
das Wochenende	the weekend
dutzend	dozen
die Möglichkeit	the possibility
die Versicherung	the insurance
die Abteilung	the department
der Kampf	the battle
der Anfang	the beginning
das Datum	the date
allgemein	generally
afrikanisch	African
es tut uns leid	sorry
die Krise	the crisis
komplett	complete
der Fan	the fan
Stock	stick
definieren	define
leicht	easily
das Loch	the hole
das Element	the element
die Vision	the vision
der Status	the status
normal	normal
Chinesisch	Chinese
das Schiff	the ship
die Lösung	the solution
der Stein	the stone
langsam	slowly
die Skala	the scale
Bit	bit
die Universität	the university
vorstellen	introduce
der Fahrer	the driver
der Versuch	the attempt
der Park	the park
die Stelle	the spot
der Mangel	the lack
das Eis	the ice
das Boot	the boat
getränk	drink
die Sonne	the sun
die Distanz	the distance
das Holz	the wood
griff	handle
der LKW	the truck
die Rückkehr	the return
der Berg	the mountain
die Umfrage	the survey
soll	supposed
die Tradition	the tradition
der Winter	the winter
das Dorf	the village
sowjetisch	Soviet
sich weigern	refuse
die Verkäufe	the sales
rollen	roll
die Kommunikation	the communication
der Lauf	the run
der Bildschirm	the screen
gewinnen	gain
der Bewohner	the resident
verbergen	hide
das Gold	the gold
der Klub	the club
Zukunft	future
der Bauernhof	the farm
potenzial	potential
der Anstieg	the increase
die Mitte	the middle
europäisch	European
das Vorhandensein	the presence
unabhängig	independent
das Viertel	the district
die Form	the shape
der Leser	the reader
der Vertrag	the contract
die Menge	the crowd
Christian	Christian
ausdrücken	express
das Apartment	the apartment
bereit	willing
die Stärke	the strength
bisherige	previous
die Band	the band
offensichtlich	obviously
das Pferd	the horse
interessiert	interested
das Ziel	the target
das Gefängnis	the prison
reiten	ride
die Wache	the guard
Bedingungen	terms
die Nachfrage	the demand
der Reporter	the reporter
liefern	deliver
der Text	the text
das Teilen	the share
das Werkzeug	the tool
wild	wild
das Fahrzeug	the vehicle
beobachten	observe
der Flug	the flight
die Einrichtung	the facility
das Verständnis	the understanding
durchschnittlich	average
entstehen	emerge
der Vorteil	the advantage
Licht	light
die Führung	the leadership
verdienen	earn
das Pfund	the pound
die Basis	the basis
hell	bright
arbeiten	operate
der Gast	the guest
die Probe	the sample
beitragen	contribute
sehr klein	tiny
der Block	the block
der Schutz	the protection
begleichen	settle
futter	feed
sammeln	collect
zusätzlich	additional
höchst	highly
die Identität	the identity
der Titel	the title
meist	mostly
der Unterricht	the lesson
der Glaube	the faith
der Fluss	the river
fördern	promote
die Lebenden	the living
anzahl	count
es sei denn	unless
heiraten	marry
morgen	tomorrow
die Technik	the technique
der Weg	the path
das Ohr	the ear
das Volk	the folk
auftrag	order
das Prinzip	the principle
überleben	survive
Aufzug	lift
die Grenze	the border
der Wettbewerb	the competition
springen	jump
versammeln	gather
Grenze	limit
passen	fit
die Forderung	the claim
schrei	cry
die Ausrüstung	the equipment
wert	worth
assoziieren	associate
der Kritiker	the critic
warm	warm
der Aspekt	the aspect
darauf bestehen	insist
der Fehlschlag	the failure
jährlich	annual
Französisch	French
Weihnachten	the Christmas
der Kommentar	the comment
verantwortlich	responsible
die Affäre	the affair
das Verfahren	the procedure
regulär	regular
verbreitung	spread
der Vorsitzende	the chairman
der Baseball	the baseball
weich	soft
ignorieren	ignore
das Ei	the egg
messen	measure
der Glaube	the belief
zeigen	demonstrate
irgendjemand	anybody
der Mord	the murder
das Geschenk	the gift
die Religion	the religion
die Überprüfung	the review
der Editor	the editor
engagieren	engage
der Kaffee	the coffee
das Dokument	the document
die Geschwindigkeit	the speed
kreuz	cross
der Einfluss	the influence
sowieso	anyway
drohen	threaten
verpflichten	commit
weiblich	female
die Jugend	the youth
die Welle	the wave
die Bewegung	the move
ängstlich	afraid
das Viertel	the quarter
der Hintergrund	the background
einheimische	native
breit	broad
wunderbar	wonderful
verweigern	deny
anscheinend	apparently
leicht	slightly
die Reaktion	the reaction
zweimal	twice
der Anzug	the suit
die Perspektive	the perspective
wachsend	growing
schlag	blow
die Konstruktion	the construction
nett	kind
die Intelligenz	the intelligence
zerstören	destroy
Koch	cook
die Verbindung	the connection
aufladen	charge
brennen	burn
der Schuh	the shoe
aussicht	view
die Note	the grade
der Kontext	the context
das Komitee	the committee
Hallo	hey
der Fehler	the mistake
der Fokus	the focus
das Lächeln	the smile
der Standort	the location
die Kleidung	the clothes
indisch	Indian
ruhig	quiet
Kleid	dress
versprechen	promise
bewusst	aware
der Nachbar	the neighbor
die Fahrt	the drive
die Funktion	the function
der Knochen	the bone
aktiv	active
erweitern	extend
Chef	chief
die durchschnittliche	the average
kombinieren	combine
der Wein	the wine
unten	below
cool	cool
der Wähler	the voter
nachfrage	demand
das Lernen	the learning
der Bus	the bus
die Hölle	the hell
gefährlich	dangerous
erinnern	remind
Moral	moral
vereinigt	united
die Kategorie	the category
verhältnismäßig	relatively
der Sieg	the victory
der Schlüssel	the key
akademisch	academic
der Besuch	the visit
das Internet	the Internet
gesund	healthy
Feuer	fire
negativ	negative
folgende	following
historisch	historical
die Medizin	the medicine
die Reise	the tour
abhängen	depend
das Foto	the photo
greifen	grab
direkte	direct
das Klassenzimmer	the classroom
der Kontakt	the contact
die Gerechtigkeit	the justice
sich beteiligen	participate
täglich	daily
messe	fair
das Paar	the pair
berühmt	famous
die Übung	the exercise
das Knie	the knee
die Blume	the flower
das Band	the tape
mieten	hire
familiär	familiar
angemessen	appropriate
die Versorgung	the supply
völlig	fully
der Schnitt	the cut
der Wille	the will
der Schauspieler	the actor
die Geburt	the birth
die Suche	the search
Krawatte	tie
die Demokratie	the democracy
östlich	eastern
primär	primary
gestern	yesterday
der Kreis	the circle
das Gerät	the device
der Fortschritt	the progress
die Front	the front
die Insel	the island
der Austausch	the exchange
reinigen	clean
das Studio	the studio
Zug	train
die Dame	the lady
der Kollege	the colleague
die Anwendung	the application
der Hals	the neck
lehnen	lean
der Schaden	the damage
der Kunststoff	the plastic
hoch	tall
der Teller	the plate
hass	hate
andernfalls	otherwise
das Schreiben	the writing
männlich	male
der Anfang	the start
am Leben	alive
der Ausdruck	the expression
der Fußball	the football
wollen	intend
attacke	attack
das Huhn	the chicken
die Armee	the army
der Missbrauch	the abuse
das Theater	the theater
geschlossen	shut
die Karte	the map
extra	extra
die Sitzung	the session
die Gefahr	the danger
herzlich willkommen	welcome
inländisch	domestic
viele	lots
die Literatur	the literature
der Regen	the rain
das Verlangen	the desire
die Beurteilung	the assessment
die Verletzung	the injury
der Respekt	the respect
nord	northern
Nicken	nod
Farbe	paint
der Treibstoff	the fuel
das Blatt	the leaf
trocken	dry
Russisch	Russian
die Anleitung	the instruction
der Kampf	the fight
der Pool	the pool
steigen	climb
süss	sweet
die Führung	the lead
der Motor	the engine
vierte	fourth
das Salz	the salt
erweitern	expand
die Wichtigkeit	the importance
das Metall	the metal
das Fett	the fat
das Ticket	the ticket
die Software	the software
verschwinden	disappear
firmen	corporate
seltsam	strange
die Lippe	the lip
das Lesen	the reading
städtisch	urban
geistig	mental
zunehmend	increasingly
das Mittagessen	the lunch
lehrreich	educational
irgendwo	somewhere
der Bauer	the farmer
der Zucker	the sugar
der Planet	the planet
favorit	favorite
erkunden	explore
erhalten	obtain
der Feind	the enemy
größte	greatest
komplex	complex
umgeben	surround
der Athlet	the athlete
einladen	invite
wiederholen	repeat
vorsichtig	carefully
die Seele	the soul
wissenschaftlich	scientific
unmöglich	impossible
die Platte	the panel
die Bedeutung	the meaning
die Mutter	the mom
verheiratet	married
das Instrument	the instrument
vorhersagen	predict
das Wetter	the weather
präsidentschafts	presidential
emotional	emotional
das Engagement	the commitment
höchste	Supreme
Bär	bear
die Tasche	the pocket
dünn	thin
die Temperatur	the temperature
die Überraschung	the surprise
die Umfrage	the poll
der Antrag	the proposal
die Konsequenz	the consequence
die Hälfte	the half
der Atem	the breath
die Sicht	the sight
die Titelseite	the cover
die Balance	the balance
adoptieren	adopt
die Minderheit	the minority
gerade	straight
Versuch	attempt
verbinden	connect
die Werke	the works
das Lehren	the teaching
gehören	belong
die Hilfe	the aid
der Ratschlag	the advice
in Ordnung	okay
die Fotografie	the photograph
leer	empty
regional	regional
der Pfad	the trail
der Roman	the novel
der Code	the code
irgendwie	somehow
organisieren	organize
die Jury	the jury
die Brust	the breast
irakisch	Iraqi
der Mensch	the human
bestätigen	acknowledge
der Sturm	the storm
die Union	the union
Aufzeichnung	record
der Schreibtisch	the desk
Angst	fear
die dank	the thanks
das Obst	the fruit
teuer	expensive
gelb	yellow
das Fazit	the conclusion
primzahl	prime
der Schatten	the shadow
Kampf	struggle
daraus schließen	conclude
der Analytiker	the analyst
der Tanz	the dance
das Limit	the limit
die Regulation	the regulation
das Sein	the being
der Ring	the ring
weitgehend	largely
Verschiebung	shift
die Einnahmen	the revenue
Kennzeichen	mark
lokalisieren	locate
der Kreis	the county
die Erscheinung	the appearance
das Paket	the package
die Schwierigkeit	the difficulty
die Brücke	the bridge
empfehlen	recommend
offensichtlich	obvious
der Zug	the train
grundsätzlich gilt	basically
die Email	the e-mail
generieren	generate
nicht mehr	anymore
vorschlagen	propose
das Denken	the thinking
möglicherweise	possibly
die Tendenz	the trend
der Besucher	the visitor
das Darlehen	the loan
zur Zeit	currently
gemütlich	comfortable
der Anleger	the investor
der Profit	the profit
wütend	angry
die Besatzung	the crew
der Unfall	the accident
der männliche	the male
die Mahlzeit	the meal
die Anhörung	the hearing
der Verkehr	the traffic
der Muskel	the muscle
die Vorstellung	the notion
erfassung	capture
bevorzugen	prefer
wirklich	truly
die Erde	the earth
japanisch	Japanese
die Brust	the chest
suche	search
dick	thick
das Geld	the cash
das Museum	the museum
die Schönheit	the beauty
der Notfall	the emergency
einzigartig	unique
Feature	feature
intern	internal
ethnisch	ethnic
Verknüpfung	link
der Stress	the stress
der Inhalt	the content
wählen	select
der Ursprung	the root
die Nase	the nose
erklären	declare
schätzen	appreciate
die Flasche	the bottle
kaum	hardly
die Einstellung	the setting
starten	launch
das Kleid	the dress
die Datei	the file
krank	sick
das Ergebnis	the outcome
die Anzeige	the ad
verteidigen	defend
Angelegenheit	matter
Richter	judge
die Pflicht	the duty
das Blatt	the sheet
sollen	ought
dafür sorgen	ensure
katholisch	Catholic
äußerst	extremely
das Ausmaß	the extent
die Komponente	the component
mischen	mix
langfristig	long-term
langsam	slow
der Kontrast	the contrast
die Zone	the zone
aufwachen	wake
Herausforderung	challenge
der Flughafen	the airport
der Chef	the chief
braun	brown
standard	standard
das Hemd	the shirt
der Pilot	the pilot
warnen	warn
letzten Endes	ultimately
die Katze	the cat
der Beitrag	the contribution
die Kapazität	the capacity
uns selbst	ourselves
das Anwesen	the estate
der Führer	the guide
der Schnee	the snow
Englisch	English
der Politiker	the politician
stehlen	steal
verfolgen	pursue
Unterhose	slip
der Prozentanteil	the percentage
das Fleisch	the meat
komisch	funny
weder	neither
die Erde	the soil
beeinflussen	influence
die Operation	the surgery
richtig	correct
jüdisch	Jewish
Schuld	blame
schätzen	estimate
fällig	due
der Basketball	the basketball
der Golf	the golf
untersuchen	investigate
verrückt	crazy
bedeutend	significantly
die Kette	the chain
die Adresse	the address
die Branche	the branch
die Kombination	the combination
häufig	frequently
der Gouverneur	the governor
das Relief	the relief
der Benutzer	the user
der Vater	the dad
kick	kick
Teil	part
die Methode	the manner
alt	ancient
die Stille	the silence
das Rating	the rating
golden	golden
Deutsche	German
das Geschlecht	the gender
lösen	solve
die Gebühr	the fee
die Landschaft	the landscape
benutzt	used
die Schale	the bowl
gleich	equal
offiziell	official
weiter	forth
der Rahmen	the frame
typisch	typical
außer	except
konservativ	conservative
beseitigen	eliminate
der Gastgeber	the host
die Halle	the hall
Vertrauen	trust
der Ozean	the ocean
Ergebnis	score
die Reihe	the row
der Produzent	the producer
sich leisten	afford
inzwischen	meanwhile
das Regime	the regime
der Unternehmensbereich	the division
bestätigen	confirm
Fix	fix
die Beschwerde	the appeal
der Spiegel	the mirror
der Zahn	the tooth
clever	smart
die Länge	the length
vollständig	entirely
verlassen	rely
beschweren	complain
Problem	issue
die Variable	the variable
Angebot	range
das Telefon	the telephone
die Wahrnehmung	the perception
anlocken	attract
das Vertrauen	the confidence
das Schlafzimmer	the bedroom
das Geheimnis	the secret
die Schuld	the debt
Selten	rare
der Panzer	the tank
die Krankenschwester	the nurse
die Abdeckung	the coverage
die Opposition	the opposition
beiseite	aside
irgendwo	anywhere
die Bindung	the bond
Datei	file
die Freude	the pleasure
der Meister	the master
die Ära	the era
die Anforderung	the requirement
die Prüfung	the check
der Stand	the stand
der Spaß	the fun
die Erwartung	the expectation
der Flügel	the wing
trennen	separate
gießen	pour
rühren	stir
das Urteil	the judgment
das Bier	the beer
das Englisch	the English
die Referenz	the reference
die Träne	the tear
der Zweifel	the doubt
gewähren	grant
ernst	seriously
Konto	account
der Minister	the minister
total	totally
der Held	the hero
industriell	industrial
die Wolke	the cloud
strecken	stretch
der Gewinner	the winner
die Lautstärke	the volume
der Samen	the seed
überrascht	surprised
sich ausruhen	rest
die Mode	the fashion
der Pfeffer	the pepper
beschäftigt	busy
die Intervention	the intervention
die Kopie	the copy
das Trinkgeld	the tip
billig	cheap
Ziel	aim
zitieren	cite
die Wohlfahrt	the welfare
das Gemüse	the vegetable
grau	gray
das Gericht	the dish
der Strand	the beach
die Verbesserung	the improvement
überall	everywhere
die Eröffnung	the opening
insgesamt	overall
Teilen	divide
Initiale	initial
furchtbar	terrible
ablehnen	oppose
zeitgenössisch	contemporary
die Route	the route
mehrere	multiple
wesentlich	essential
Frage	question
die Liga	the league
Verbrecher	criminal
Vorsichtig	careful
der Kern	the core
eilen	rush
Notwendig	necessarily
speziell	specifically
müde	tired
der Aufgang	the rise
die Krawatte	the tie
beschäftigen	employ
der Urlaub	the holiday
tanzen	dance
die Auflösung	the resolution
der Haushalt	the household
die Abtreibung	the abortion
ein Teil	apart
der Zeuge	the witness
Spiel	match
kaum	barely
der Sektor	the sector
der Abgeordnete	the representative
Mangel	lack
neben	beside
das Schwarze	the black
der Vorfall	the incident
begrenzt	limited
stolz	proud
die Strömung	the flow
die Fakultät	the faculty
erhöht	increased
der Müll	the waste
die Masse	the mass
betonen	emphasize
das Experiment	the experiment
bestimmt	definitely
die Bombe	the bomb
enorm	enormous
der Ton	the tone
Liberale	liberal
massiv	massive
der Ingenieur	the engineer
das Rad	the wheel
das Weibchen	the female
Ablehnen	decline
investieren	invest
das Versprechen	the promise
das Kabel	the cable
gegenüber	towards
entlarven	expose
ländlich	rural
die AIDS	the AIDS
der Jude	the Jew
eng	narrow
die Creme	the cream
die Sekretärin	the secretary
das Tor	the gate
solide	solid
der Hügel	the hill
typisch	typically
der Lärm	the noise
das Gras	the grass
Unglücklicherweise	unfortunately
der Hut	the hat
die Gesetzgebung	the legislation
gelingen	succeed
feiern	celebrate
die Leistung	the achievement
das fischen	the fishing
das Getränk	the drink
beschuldigen	accuse
Hand	hand
sinnvoll	useful
Land	land
Geheimnis	secret
das Talent	the talent
der Geschmack	the taste
das Merkmal	the characteristic
die Milch	the milk
Flucht	escape
Besetzung	cast
der Satz	the sentence
ungewöhnlich	unusual
eng	closely
überzeugen	convince
die Höhe	the height
der Physiker	the physician
beurteilen	assess
der Schlaf	the sleep
reichlich	plenty
die Fahrt	the ride
virtuell	virtually
Zusatz	addition
Scharf	sharp
kreativ	creative
niedriger	lower
genehmigen	approve
die Erklärung	the explanation
Fröhlich	gay
der Campus	the campus
richtig	proper
schuldig	guilty
erwerben	acquire
konkurrieren	compete
technisch	technical
Plus	plus
Verstand	mind
das Potenzial	the potential
der Immigrant	the immigrant
schwach	weak
illegal	illegal
Hallo	hi
die Alternative	the alternative
die Interaktion	the interaction
die Kolumne	the column
die Persönlichkeit	the personality
das Signal	the signal
der Lebenslauf	the curriculum
Liste	list
die Ehre	the honor
der Passagier	the passenger
die Unterstützung	the assistance
für immer	forever
Spaß	fun
betrachten	regard
israelisch	Israeli
der Verein	the association
zwanzig	twenty
klopfen	knock
Rezension	review
wickeln	wrap
das Labor	the lab
das Angebot	the offer
Anzeige	display
die Kritik	the criticism
das Kapital	the asset
die Depression	the depression
geistig	spiritual
Musical	musical
der Journalist	the journalist
das Gebet	the prayer
vermuten	suspect
der Gelehrte	the scholar
die Warnung	the warning
das Klima	the climate
der Käse	the cheese
die Beobachtung	the observation
die Kindheit	the childhood
die Bezahlung	the payment
der sir	the sir
erlauben	permit
die Zigarette	the cigarette
die Definition	the definition
die Priorität	the priority
das Brot	the bread
die Kreation	the creation
der Absolvent	the graduate
die Anfrage	the request
das Gefühl	the emotion
Schrei	scream
dramatisch	dramatic
das Universum	the universe
die Lücke	the gap
Ausgezeichnet	excellent
der Staatsanwalt	the prosecutor
die Note	the mark
das Grün	the green
Glücklich	lucky
ziehen	drag
die Fluggesellschaft	the airline
die Bibliothek	the library
die Tagesordnung	the agenda
genesen	recover
die Fabrik	the factory
die Auswahl	the selection
in erster Linie	primarily
das Dach	the roof
unfähig	unable
die Kosten	the expense
die Initiative	the initiative
die Diät	the diet
Festnahme	arrest
die finanzierung	the funding
die Therapie	the therapy
waschen	wash
der Stundenplan	the schedule
traurig	sad
kurz	brief
das Gehäuse	the housing
die Post	the post
Kauf	purchase
bestehende	existing
die Dunkelheit	the dark
der Stahl	the steel
bezüglich	regarding
schreien	shout
verbleibend	remaining
visuell	visual
ziemlich	fairly
der Chip	the chip
heftig	violent
Leise	silent
annehmen	suppose
das Ich	the self
das Fahrrad	the bike
der Tee	the tea
wahrnehmen	perceive
der Vergleich	the comparison
die Siedlung	the settlement
die Schicht	the layer
die Planung	the planning
die Beschreibung	the description
rutschen	slide
die Hochzeit	the wedding
informieren	inform
die Portion	the portion
das Territorium	the territory
sofortig	immediate
der Gegner	the opponent
der Link	the link
Masse	mass
der See	the lake
verwandeln	transform
die Spannung	the tension
der Bildschirm	the display
führend	leading
Mühe	bother
bestehen	consist
der Alkohol	the alcohol
aktivieren	enable
Biege	bend
der Gewinn	the gain
die Wüste	the desert
soll	shall
der Fehler	the error
die Freisetzung	the release
der Polizist	the cop
Araber	Arab
doppelt	double
das Wandern	the walk
der Sand	the sand
Spanisch	Spanish
Regel	rule
der Schlag	the hit
der Druck	the print
der Durchgang	the passage
formal	formal
der Übergang	the transition
die Existenz	the existence
das Album	the album
die Teilnahme	the participation
ordnen	arrange
Atmosphäre	the atmosphere
Joint	joint
Antworten	reply
der Kreislauf	the cycle
Gegenteil	opposite
sperren	lock
das Ganze	the whole
verdienen	deserve
konsistent	consistent
der Widerstand	the resistance
die Entdeckung	the discovery
reißen	tear
die Belichtung	the exposure
Pose	pose
der Strom	the stream
der Verkauf	the sale
das Vertrauen	the trust
Vorteil	benefit
der Topf	the pot
großartig	grand
Bergwerk	mine
die Koalition	the coalition
das Märchen	the tale
das Messer	the knife
Entschlossenheit	resolve
rassisch	racial
die Phase	the phase
das Geschenk	the present
der Witz	the joke
der Mantel	the coat
Mexikaner	Mexican
das Symptom	the symptom
Kontakt	contact
der Hersteller	the manufacturer
die Philosophie	the philosophy
die Kartoffel	the potato
Interview	interview
die Grundlage	the foundation
Zitat	quote
online	online
der Pass	the pass
die Verhandlung	the negotiation
Drang	urge
der Anlass	the occasion
der Staub	the dust
atmen	breathe
die Ermittler	the investigator
die Jacke	the jacket
froh	glad
gewöhnliche	ordinary
die Reduzierung	the reduction
selten	rarely
die Verschiebung	the shift
Pack	pack
der Selbstmord	the suicide
zahlreich	numerous
die Berührung	the touch
die Substanz	the substance
die Disziplin	the discipline
anderswo	elsewhere
das Bügeleisen	the iron
praktisch	practical
Außerdem	moreover
die Leidenschaft	the passion
die Freiwillige	the volunteer
implementieren	implement
im Wesentlichen	essentially
die Durchsetzung	the enforcement
vs	vs
die Soße	the sauce
die Unabhängigkeit	the independence
das Marketing	the marketing
der Priester	the priest
tolle	amazing
heftig	intense
der Fortschritt	the advance
der Arbeitgeber	the employer
der Schock	the shock
inspirieren	inspire
einstellen	adjust
in den Ruhestand gehen	retire
sichtbar	visible
Kuss	kiss
die Krankheit	the illness
die Kappe	the cap
die Angewohnheit	the habit
wettbewerbsfähig	competitive
der Saft	the juice
Kongress	congressional
die Beteiligung	the involvement
dominieren	dominate
vorher	previously
wann auch immer	whenever
Transfer	transfer
analysieren	analyze
anfügen	attach
der Inder	the Indian
das Unglück	the disaster
der Parkplatz	the parking
das Prospekt	the prospect
der Chef	the boss
die Beschwerde	the complaint
die Meisterschaft	the championship
Trainer	coach
Übung	exercise
fundamental	fundamental
verbessern	enhance
das Mysterium	the mystery
auferlegen	impose
die Armut	the poverty
der Eintritt	the entry
Fett	fat
die Ausgaben	the spending
der König	the king
bewerten	evaluate
das Symbol	the symbol
Handel	trade
der Macher	the maker
die Stimmung	the mood
erreichen	accomplish
der Schwerpunkt	the emphasis
veranschaulichen	illustrate
das Boot	the boot
Monitor	monitor
asiatisch	Asian
die Unterhaltung	the entertainment
die Bohne	the bean
die Bewertung	the evaluation
die Kreatur	the creature
der Kommandant	the commander
Digital	digital
die Anordnung	the arrangement
konzentrieren	concentrate
die Gesamt	the total
gewöhnlich	usual
die Wut	the anger
psychologisch	psychological
der Spitzer	the peak
ca	approximately
steigend	increasing
die Störung	the disorder
die Rakete	the missile
gleichermaßen	equally
variieren	vary
das Kabel	the wire
die Runde	the round
der Vertrieb	the distribution
der Transport	the transportation
heilig	holy
Ring	ring
der Zwilling	the twin
der Befehl	the command
die Kommission	the commission
die Interpretation	the interpretation
das Frühstück	the breakfast
der Halt	the stop
stark	strongly
das Ingenieurwesen	the engineering
das Glück	the luck
sogenannt	so-called
Konstante	constant
Rennen	race
die Klinik	the clinic
der Veteran	the veteran
Geruch	smell
die Esslöffel	the tablespoon
fähig	capable
nervös	nervous
der Tourist	the tourist
werfen	toss
entscheidend	crucial
begraben	bury
beten	pray
die Tomate	the tomato
die Ausnahme	the exception
die Butter	the butter
das Defizit	the deficit
das Bad	the bathroom
Block	block
elektronisch	electronic
der Verbündete	the ally
der Ruf	the reputation
die Mischung	the mixture
sicherlich	surely
der Turm	the tower
der Rauch	the smoke
konfrontieren	confront
rein	pure
Blick	glance
die Dimension	the dimension
das Spielzeug	the toy
der Häftling	the prisoner
Gefährte	fellow
glatt	smooth
in der Nähe	nearby
der Peer	the peer
der Designer	the designer
das Personal	the personnel
gestalten	shape
der Erzieher	the educator
die relativen	the relative
die Einwanderung	the immigration
der Gürtel	the belt
der Teelöffel	the teaspoon
der Geburtstag	the birthday
die Implikation	the implication
perfekt	perfectly
die Küste	the coast
der Unterstützer	the supporter
begleiten	accompany
das Silber	the silver
der Teenager	the teenager
die Erkennung	the recognition
das Renten	the retirement
die Flagge	the flag
die Wiederherstellung	the recovery
flüstern	whisper
die Uhr	the watch
der Gentleman	the gentleman
der Mais	the corn
der Mond	the moon
innere	inner
Junior	junior
die Kehle	the throat
das Gehalt	the salary
Swing	swing
der Beobachter	the observer
die Veröffentlichung	the publication
die Ernte	the crop
graben	dig
der Streik	the strike
permanent	permanent
Pflanze	plant
das Phänomen	the phenomenon
die Angst	the anxiety
nicht wie	unlike
nass	wet
buchstäblich	literally
widerstehen	resist
das Treffen	the convention
Umarmung	embrace
liefern	supply
helfen	assist
die Ausstellung	the exhibition
bauen	construct
der Beobachter	the viewer
die Pfanne	the pan
der Berater	the consultant
Linie	line
der Administrator	the administrator
Datum	date
gelegentlich	occasionally
der Bürgermeister	the mayor
die Gegenleistung	the consideration
der Geschäftsführer	the CEO
sichern	secure
Rosa	pink
Rauch	smoke
die Schätzung	the estimate
der Bock	the buck
historisch	historic
das Gedicht	the poem
die Großmutter	the grandmother
binden	bind
fünfte	fifth
ständig	constantly
das Unternehmen	the enterprise
Gefallen	favor
die Prüfung	the testing
der Magen	the stomach
ersichtlich	apparent
wiegen	weigh
Installieren	install
empfindlich	sensitive
der Vorschlag	the suggestion
die Post	the mail
das Rezept	the recipe
angemessen	reasonable
die Vorbereitung	the preparation
hölzern	wooden
elementar	elementary
das Konzert	the concert
aggressiv	aggressive
FALSCH	FALSE
die Absicht	the intention
der Kanal	the channel
extrem	extreme
das Rohr	the tube
die Zeichnung	the drawing
das Protein	the protein
die Abwesenheit	the absence
die Rolle	the roll
Latein	Latin
das Gefängnis	the jail
Kommentar	comment
die Vielfalt	the diversity
ehrlich	honest
palästinensisch	Palestinian
die Geschwindigkeit	the pace
die Anstellung	the employment
der Lautsprecher	the speaker
der Eindruck	the impression
der Aufsatz	the essay
der Antwortende	the respondent
Riese	giant
der Kuchen	the cake
der Historiker	the historian
verhandeln	negotiate
wiederherstellen	restore
wesentlich	substantial
Pop	pop
der Spezialist	the specialist
der Ursprung	the origin
die Freigabe	the approval
die Mine	the mine
ruhig	quietly
beraten	advise
konventionell	conventional
der Fall	the drop
die Zählung	the count
die Tiefe	the depth
der Reichtum	the wealth
die Behinderung	the disability
die Muschel	the shell
kritisieren	criticize
der Profi	the professional
effektiv	effectively
biologisch	biological
die Packung	the pack
die Zwiebel	the onion
der Stellvertreter	the deputy
eben	flat
die Marke	the brand
versichern	assure
wütend	mad
die Auszeichnung	the award
das Kriterium	the criteria
der Händler	the dealer
Alternative	alternative
das Dienstprogramm	the utility
genau	precisely
entstehen	arise
bewaffnet	armed
Dennoch	nevertheless
die Autobahn	the highway
klinisch	clinical
die Routine	the routine
Zeitplan	schedule
der Lohn	the wage
normalerweise	normally
die Zutat	the ingredient
die Beteiligung	the stake
Muslim	Muslim
Traum	dream
die Faser	the fiber
der Aktivist	the activist
islamisch	Islamic
Druckknopf	snap
der Terrorismus	the terrorism
der Flüchtling	the refugee
Übernehmen	incorporate
die Hüfte	the hip
Schalter	switch
wertvoll	valuable
die Annahme	the assumption
die Ausrüstung	the gear
Absolvent	graduate
die Barriere	the barrier
geringer	minor
die Provision	the provision
der Mörder	the killer
zuordnen	assign
die Gruppe	the gang
Entwicklung	developing
klassisch	classic
die Chemikalie	the chemical
Welle	wave
das Etikett	the label
der Teenager	the teen
der Index	the index
der Urlaub	the vacation
der Anwalt	the advocate
der Entwurf	the draft
außergewöhnlich	extraordinary
der Himmel	the heaven
Rau	rough
schwanger	pregnant
entfernt	distant
das Drama	the drama
der Satellit	the satellite
persönlich	personally
das Wunder	the wonder
die Uhr	the clock
die Schokolade	the chocolate
Italienisch	Italian
kanadisch	Canadian
die Decke	the ceiling
fegen	sweep
die Werbung	the advertising
Universal	universal
Dreh	spin
Haus	house
die Taste	the button
die Glocke	the bell
der Rang	the rank
die Dunkelheit	the darkness
die Bekleidung	the clothing
Super	super
Ausbeute	yield
der Zaun	the fence
das Porträt	the portrait
die Farbe	the paint
das Überleben	the survival
grob	roughly
die Klage	the lawsuit
Unterseite	bottom
das Zeugnis	the testimony
das Bündel	the bunch
der Beat	the beat
Wind	wind
gefunden	found
die Last	the burden
reagieren	react
die Kammer	the chamber
die Möbel	the furniture
die Kooperation	the cooperation
die Saite	the string
die Zeremonie	the ceremony
kommunizieren	communicate
Geschmack	taste
die Wange	the cheek
hat verloren	lost
das Profil	the profile
der Mechanismus	the mechanism
nicht zustimmen	disagree
die Strafe	the penalty
das Match	the match
vorrücken	advance
das Resort	the resort
die Zerstörung	the destruction
der Bär	the bear
unwahrscheinlich	unlikely
das Gewebe	the tissue
Verfassungs	constitutional
der Fremde	the stranger
die Infektion	the infection
das Kabinett	the cabinet
gebrochen	broken
der Apfel	the apple
elektrisch	electric
Vorgehen	proceed
Spur	track
Wette	bet
literarisch	literary
der Virus	the virus
blöd	stupid
der Streit	the dispute
das Glück	the fortune
strategisch	strategic
der Assistent	the assistant
überwinden	overcome
bemerkenswert	remarkable
besetzen	occupy
die Statistiken	the statistics
das Einkaufen	the shopping
der Cousin	the cousin
Begegnung	encounter
wischen	wipe
anfänglich	initially
blind	blind
das weiß	the white
der Hafen	the port
Ehre	honor
der Strom	the electricity
genetisch	genetic
der Berater	the adviser
die Bezahlung	the pay
der Sprecher	the spokesman
behalten	retain
letztere	latter
der Anreiz	the incentive
der Sklave	the slave
chemisch	chemical
Übersetzen	translate
wohingegen	whereas
der Terror	the terror
die Erweiterung	the expansion
die Elite	the elite
olympisch	Olympic
der Dreck	the dirt
ungerade	odd
der Reis	the rice
die Kugel	the bullet
fest	tight
die Bibel	the Bible
die Grafik	the chart
Solar	solar
der Rückgang	the decline
die konservative	the conservative
verarbeiten	process
Platz	square
der Stock	the stick
die Konzentration	the concentration
kompliziert	complicated
sanft	gently
der Meister	the champion
das Szenario	the scenario
das Teleskop	the telescope
die Reflektion	the reflection
die Revolution	the revolution
der Streifen	the strip
interpretieren	interpret
freundlich	friendly
der Wettbewerb	the tournament
die Fiktion	the fiction
entdecken	detect
Balance	balance
die Lebensdauer	the lifetime
die Empfehlung	the recommendation
fließen	flow
der Senator	the senator
Markt	market
die Jagd	the hunting
der Salat	the salad
Garantie	guarantee
unschuldig	innocent
die Grenze	the boundary
Pause	pause
entfernt	remote
die Zufriedenheit	the satisfaction
das Tagebuch	the journal
die Bank	the bench
der Liebhaber	the lover
roh	raw
das Bewusstsein	the awareness
überraschend	surprising
abheben	withdraw
die allgemeine	the general
das Deck	the deck
ähnlich	similarly
neu	newly
der Pol	the pole
bezeugen	testify
der Modus	the mode
der Dialog	the dialogue
implizieren	imply
natürlich	naturally
gegenseitig	mutual
der Gründer	the founder
fortgeschritten	advanced
der Stolz	the pride
entlassen	dismiss
das Flugzeug	the aircraft
die Lieferung	the delivery
hauptsächlich	mainly
backen	bake
einfrieren	freeze
die Platform	the platform
die Finanzen	the finance
sinken	sink
attraktiv	attractive
Respekt	respect
vielfältig	diverse
relevant	relevant
Ideal	ideal
die Freude	the joy
der wert	the worth
regelmäßig	regularly
Arbeiten	working
der Sänger	the singer
entwickeln	evolve
das Shooting	the shooting
teilweise	partly
unbekannte	unknown
Assistent	assistant
die Offensive	the offense
der Zähler	the counter
die DNA	the DNA
der Geruch	the smell
möglicherweise	potentially
die Übertragung	the transfer
dreißig	thirty
rechtfertigen	justify
der Protest	the protest
der Absturz	the crash
das Handwerk	the craft
der Vertrag	the treaty
der Terrorist	the terrorist
die Einsicht	the insight
politisch	politically
Zapfhahn	tap
die Lüge	the lie
umfangreich	extensive
die Folge	the episode
schwimmen	swim
Reifen	tire
lose	loose
ursprünglich	originally
beträchtlich	considerable
intellektuelle	intellectual
die Mischung	the mix
der Angriff	the assault
Entspannen Sie Sich	relax
die Treppen	the stair
das Abenteuer	the adventure
extern	external
der Beweis	the proof
zuversichtlich	confident
das Hauptquartier	the headquarters
plötzlich	sudden
dreckig	dirty
die Verletzung	the violation
die Zunge	the tongue
die Lizenz	the license
der Halt	the hold
die Zuflucht	the shelter
reiben	rub
die Kontroverse	the controversy
der Eingang	the entrance
der Favorit	the favorite
trainieren	practice
verblassen	fade
Defensive	defensive
die Tragödie	the tragedy
das Netz	the net
charakterisieren	characterize
die Beerdigung	the funeral
der Beruf	the profession
ändern	alter
Stelle	spot
bilden	constitute
die Einrichtung	the establishment
drücken	squeeze
die Vorstellung	the imagination
Ziel	target
die Maske	the mask
Konvertieren	convert
umfassend	comprehensive
prominent	prominent
die Präsentation	the presentation
ungeachtet	regardless
Belastung	load
stabil	stable
die Einleitung	the introduction
Beschwerde	appeal
so tun als ob	pretend
Alten	elderly
die Repräsentation	the representation
das Reh	the deer
Teilt	split
verletzen	violate
die Partnerschaft	the partnership
die Verschmutzung	the pollution
die Emissions	the emission
stetig	steady
vital	vital
das Schicksal	the fate
der Ofen	the oven
die Unterscheidung	the distinction
das Segment	the segment
nirgends	nowhere
der Poet	the poet
bloß	mere
aufregend	exciting
die Variation	the variation
der Komfort	the comfort
Radikale	radical
Stress	stress
anpassen	adapt
irisch	Irish
der Honig	the honey
der Korrespondent	the correspondent
blass	pale
der Musiker	the musician
die Signifikanz	the significance
die Ladung	the load
runden	round
das Schiff	the vessel
der Speicher	the storage
fliehen	flee
das Leder	the leather
verteilen	distribute
die Evolution	the evolution
krank	ill
der Stamm	the tribe
das Regal	the shelf
die Dose	the can
der Großvater	the grandfather
der Rasen	the lawn
der Käufer	the buyer
die Speise	the dining
die Weisheit	the wisdom
der Rat	the council
verletzlich	vulnerable
die Instanz	the instance
der Knoblauch	the garlic
die Fähigkeit	the capability
die Poesie	the poetry
der Prominente	the celebrity
allmählich	gradually
die Stabilität	the stability
Zweifel	doubt
die Fantasie	the fantasy
erschrocken	scared
führen	guide
die Handlung	the plot
der Rahmen	the framework
die Geste	the gesture
abhängig	depending
laufend	ongoing
die Psychologie	the psychology
der Ratgeber	the counselor
Zeuge	witness
das Kapitel	the chapter
der Gefährte	the fellow
die Scheidung	the divorce
verdanken	owe
das Rohr	the pipe
sportlich	athletic
die Mathematik	the math
die Schattierung	the shade
der Schweif	the tail
montieren	mount
die Verpflichtung	the obligation
der Winkel	the angle
die Palme	the palm
abweichen	differ
der Brauch	the custom
Geschäft	store
der Ökonom	the economist
fünfzehn	fifteen
die Suppe	the soup
die Feier	the celebration
effizient	efficient
Beschädigung	damage
die Zusammensetzung	the composition
erfüllen	satisfy
der Stapel	the pile
der Kohlenstoff	the carbon
näher	closer
verbrauchen	consume
die Regelung	the scheme
der Riss	the crack
die Frequenz	the frequency
der Tabak	the tobacco
der Überlebende	the survivor
Außerdem	besides
der Psychologe	the psychologist
reich	wealthy
die Galaxie	the galaxy
gegeben	given
Fonds	fund
der Ski	the ski
die Begrenzung	the limitation
Spur	trace
der Termin	the appointment
die Präferenz	the preference
der Meter	the meter
die Explosion	the explosion
die Festnahme	the arrest
öffentlich	publicly
unglaublich	incredible
der Kämpfer	the fighter
der Eintritt	the admission
der Jäger	the hunter
erziehen	educate
schmerzlich	painful
die Freundschaft	the friendship
der Adjutant	the aide
Berechnung	calculate
fünfzig	fifty
loswerden	rid
die Veranda	the porch
die Tendenz	the tendency
die Uniform	the uniform
die Formation	the formation
das Stipendium	the scholarship
die Reservierung	the reservation
die Effizienz	the efficiency
Abfall	waste
qualifizieren	qualify
das Einkaufszentrum	the mall
ableiten	derive
der Skandal	the scandal
der PC	the PC
hilfreich	helpful
beeindrucken	impress
die Ferse	the heel
ähneln	resemble
die Privatsphäre	the privacy
das Gewebe	the fabric
Überraschung	surprise
der Anteil	the proportion
die Leitlinie	the guideline
das Gewehr	the rifle
die Wartung	the maintenance
der Trick	the trick
organisch	organic
das Zelt	the tent
die Untersuchung	the examination
der Herausgeber	the publisher
stärken	strengthen
die Franzosen	the French
vorgeschlagen	proposed
der Mythos	the myth
anspruchsvoll	sophisticated
die Kuh	the cow
etc	etc
der Stand	the standing
schlafend	asleep
das Tennis	the tennis
der Nerv	the nerve
das Fass	the barrel
das Bombardement	the bombing
die Mitgliedschaft	the membership
das Verhältnis	the ratio
das Menü	the menu
der Kauf	the purchase
umstritten	controversial
verzweifelt	desperate
Bewertung	rate
der Lifestyle	the lifestyle
der Humor	the humor
laut	loud
der Handschuh	the glove
der Verdächtige	the suspect
ausreichend	sufficient
die Erzählung	the narrative
der Fotograf	the photographer
der Hubschrauber	the helicopter
die katholische	the Catholic
bescheiden	modest
der Provider	the provider
die Verzögerung	the delay
landwirtschaftlich	agricultural
explodieren	explode
der Hub	the stroke
der Anwendungsbereich	the scope
die Bestrafung	the punishment
die Handvoll	the handful
schlecht	badly
der Horizont	the horizon
neugierig	curious
Innenstadt	downtown
die Freundin	the girlfriend
prompt	prompt
anfordern	request
das Cholesterin	the cholesterol
absorbieren	absorb
die Angleichung	the adjustment
die Steuerzahler	the taxpayer
eifrig	eager
der Rektor	the principal
ausführlich	detailed
die Motivation	the motivation
die Zuordnung	the assignment
die Beschränkung	the restriction
die palästinensische	the Palestinian
das Labor	the laboratory
der Workshop	the workshop
anders	differently
das Auto	the auto
romantisch	romantic
die Baumwolle	the cotton
der Motor	the motor
verklagen	sue
der Geschmack	the flavor
übersehen	overlook
schweben	float
erfahren	undergo
die Sequenz	the sequence
die Demonstration	the demonstration
der Jet	the jet
Orange	orange
der Verbrauch	the consumption
behaupten	assert
die Klinge	the blade
vorübergehend	temporary
das Medikament	the medication
drucken	print
die Kajüte	the cabin
beißen	bite
relativ	relative
die Ausgabe	the edition
das Tal	the valley
deine	yours
die Tonhöhe	the pitch
der Kiefer	the pine
brillant	brilliant
gegen	versus
die Herstellungs	the manufacturing
Risiko	risk
der Christian	the Christian
der Komplex	the complex
absolut	absolute
der Küchenchef	the chef
die Diskriminierung	the discrimination
beleidigend	offensive
das deutsch	the German
passen	suit
der Boom	the boom
registrieren	register
ernennen	appoint
das Erbe	the heritage
der Gott	the God
Terrorist	terrorist
Dominant	dominant
erfolgreich	successfully
die Scheiße	the shit
die Zitrone	the lemon
hungrig	hungry
Sinn	sense
wandern	wander
einreichen	submit
die Wirtschaft	the economics
nackt	naked
erwarten	anticipate
die Nuss	the nut
das Vermächtnis	the legacy
die Erweiterung	the extension
zucken	shrug
die Fliege	the fly
die Batterie	the battery
die Ankunft	the arrival
legitim	legitimate
die Ausrichtung	the orientation
die Inflation	the inflation
zurechtkommen	cope
die Flamme	the flame
der Cluster	the cluster
Gastgeber	host
die Wunde	the wound
abhängig	dependent
die Dusche	the shower
institutionell	institutional
darstellen	depict
das Betriebs	the operating
das Fleisch	the flesh
die Garage	the garage
der Betreiber	the operator
der Lehrer	the instructor
Zusammenbruch	collapse
leihen	borrow
die Komödie	the comedy
die Hypothek	the mortgage
Zivilist	civilian
zwölf	twelve
wöchentlich	weekly
das Habitat	the habitat
das Getreide	the grain
Bürste	brush
das Bewußtsein	the consciousness
widmen	devote
Riss	crack
die Messung	the measurement
die Provinz	the province
Leichtigkeit	ease
ergreifen	seize
die Ethik	the ethics
die Nominierung	the nomination
die Erlaubnis	the permission
weise	wise
die Schauspielerin	the actress
der Gipfel	the summit
die Säure	the acid
die Chancen	the odds
begabtes	gifted
die Frustration	the frustration
das Medium	the medium
Funktion	function
physisch	physically
der Zuschuss	the grant
unterscheiden	distinguish
die Küste	the shore
wiederholt	repeatedly
die Lunge	the lung
Feste	firm
Laufen	running
verschieden	distinct
künstlerisch	artistic
der Diskurs	the discourse
der Korb	the basket
Ah	ah
beeindruckend	impressive
der Wettbewerber	the competitor
hässlich	ugly
besorgt	worried
porträtieren	portray
das Pulver	the powder
das Gespenst	the ghost
überzeugen	persuade
mäßig	moderate
anschließend	subsequent
Fortsetzung	continued
der Keks	the cookie
die Karriere	the carrier
das Kochen	the cooking
Verbot	ban
die Schaukel	the swing
die Orange	the orange
furchtbar	awful
bewundern	admire
das Haustier	the pet
das Wunder	the miracle
überschreiten	exceed
der Rhythmus	the rhythm
weit verbreitet	widespread
das Töten	the killing
schön	lovely
die Sünde	the sin
die Wohlfahrt	the charity
das Skript	the script
die Taktik	the tactic
die Identifikation	the identification
die Transformation	the transformation
jeden Tag	everyday
die Schlagzeile	the headline
Absturz	crash
die Venture	the venture
die Invasion	the invasion
das Militär	the military
dennoch	nonetheless
angemessene	adequate
das Klavier	the piano
das Lebensmittelgeschäft	the grocery
die Intensität	the intensity
Ausstellungsstück	exhibit
die Decke	the blanket
der Abstand	the margin
Schulleiter	principal
der Quarterback	the quarterback
die Maus	the mouse
das Seil	the rope
Beton	concrete
das Rezept	the prescription
Afroamerikaner	African-American
Verfolgungsjagd	chase
Dokument	document
der Ziegelstein	the brick
rekrutieren	recruit
der Patch	the patch
der Konsens	the consensus
der Horror	the horror
die Aufnahme	the recording
Ändern	changing
der Maler	the painter
kolonial	colonial
der Kuchen	the pie
das Wohl	the sake
der Blick	the gaze
der Mut	the courage
die Schwangerschaft	the pregnancy
schwören	swear
Niederlage	defeat
der Hinweis	the clue
verstärken	reinforce
der Sieg	the win
die Verwirrung	the confusion
die Scheibe	the slice
die Tätigkeit	the occupation
sehr geehrter	dear
die Kohle	the coal
heilig	sacred
der Kriminelle	the criminal
die Formel	the formula
kognitiv	cognitive
Kollektiv	collective
der Onkel	the uncle
das Quadrat	the square
der Kapitän	the captain
Seufzer	sigh
Attribut	attribute
Wagen	dare
obdachlos	homeless
die Gallerie	the gallery
Fußball	the soccer
der Verteidiger	the defendant
der Tunnel	the tunnel
die Fitness	the fitness
die Runde	the lap
das Grab	the grave
die Zehe	the toe
der Kontainer	the container
die Tugend	the virtue
im Ausland	abroad
der Architekt	the architect
dramatisch	dramatically
das Make-Up	the makeup
die Anfrage	the inquiry
die Rose	the rose
überraschenderweise	surprisingly
Markieren	highlight
verringern	decrease
die Angabe	the indication
die Schiene	the rail
der Jahrestag	the anniversary
die Couch	the couch
die Allianz	the alliance
die Hypothese	the hypothesis
der Freund	the boyfriend
komponieren	compose
Peer	peer
die Unordnung	the mess
Rang	rank
die Legende	the legend
regulieren	regulate
der jugendliche	the adolescent
scheinen	shine
die Norm	the norm
verärgert	upset
die Bemerkung	the remark
zurücktreten	resign
die Belohnung	the reward
sanft	gentle
verbunden	related
das Organ	the organ
erfinden	invent
das Lachen	the laughter
der Nordwesten	the northwest
die Beratung	the counseling
der Empfänger	the receiver
das Ritual	the ritual
das Insekt	the insect
unterbrechen	interrupt
der Lachs	the salmon
der Gefallen	the favor
das Handels	the trading
Zauber	magic
überlegen	superior
der Stamm	the stem
der Chirurg	the surgeon
akzeptabel	acceptable
die Physik	the physics
die Vergewaltigung	the rape
der Rat	the counsel
die Bürste	the brush
die Jeans	the jeans
Jagd	hunt
kontinuierlich	continuous
das Protokoll	the log
Echo	echo
die Pille	the pill
aufgeregt	excited
die Skulptur	the sculpture
die Verbindung	the compound
integrieren	integrate
das Mehl	the flour
bitter	bitter
blank	bare
die Piste	the slope
Miete	rent
die Präsidentschaft	the presidency
die Portion	the serving
subtil	subtle
der Bischof	the bishop
das trinken	the drinking
verzögern	delay
der Schrei	the cry
die Akzeptanz	the acceptance
der Kollaps	the collapse
Geschäft	shop
die Pumpe	the pump
die Süßigkeit	the candy
das Böse	the evil
das endgültige	the final
Finanzen	finance
zufrieden	pleased
die Medaille	the medal
bitten	beg
Sponsor	sponsor
ethisch	ethical
Sekundär	secondary
zuschlagen	slam
die Ausfuhr	the export
Experimental	experimental
Schmelze	melt
die Mitternacht	the midnight
Netz	net
die Kurve	the curve
die Integrität	the integrity
berechtigen	entitle
die Logik	the logic
die Essenz	the essence
Park	park
ausschließen	exclude
der Schrank	the closet
Vorort	suburban
grüßen	greet
der Innenraum	the interior
der Korridor	the corridor
Mord	murder
Verkauf	retail
der Krug	the pitcher
März	march
die Schlange	the snake
Tonhöhe	pitch
Ausrede	excuse
das Kreuz	the cross
die Schwäche	the weakness
das Schwein	the pig
die Kälte	the cold
klassisch	classical
das T-Shirt	the T-shirt
die Arbeitslosigkeit	the unemployment
die Zivilisation	the civilization
falten	fold
geduldig	patient
der Pop	the pop
umkehren	reverse
fehlt	missing
die Korrelation	the correlation
die Menschlichkeit	the humanity
Blitz	flash
der Entwickler	the developer
zuverlässig	reliable
die Aufregung	the excitement
der Islam	the Islam
römisch	Roman
die Strecke	the stretch
die Architektur	the architecture
gelegentlich	occasional
administrativ	administrative
der Ellbogen	the elbow
tötlich	deadly
der Muslim	the Muslim
spanisch	Hispanic
Spitze	tip
verwechseln	confuse
monatlich	monthly
die Ente	the duck
die Dosis	the dose
Koreanisch	Korean
plädieren	plead
einleiten	initiate
der Vortrag	the lecture
der Van	the van
sechste	sixth
die Bucht	the bay
Mainstream	mainstream
die Vorstadt	the suburb
das Sandwich	the sandwich
der Kofferraum	the trunk
das Gerücht	the rumor
die Umsetzung	the implementation
schlucken	swallow
motivieren	motivate
lange Zeit	longtime
Falle	trap
beschränken	restrict
die Kleidung	the cloth
scheinbar	seemingly
Gesetzgebungs	legislative
die Wirksamkeit	the effectiveness
erzwingen	enforce
die Linse	the lens
die Reichweite	the reach
der Inspektor	the inspector
verleihen	lend
der Betrug	the fraud
der Begleiter	the companion
kämpfen	contend
der Nagel	the nail
das Array	the array
streng	strict
montieren	assemble
offen	frankly
die Ratte	the rat
platzen	burst
der Flur	the hallway
die Höhle	the cave
unvermeidlich	inevitable
der Südwesten	the southwest
das Monster	the monster
Geschwindigkeit	speed
Protest	protest
unerwartet	unexpected
das Hindernis	the obstacle
erleichtern	facilitate
die Begegnung	the encounter
Ruhe in Frieden	rip
das Kraut	the herb
überwältigend	overwhelming
die Integration	the integration
der Kristall	the crystal
die Rezession	the recession
der Wunsch	the wish
geschrieben	written
das Motiv	the motive
Etikette	label
das Hochwasser	the flood
der Stift	the pen
das eigentum	the ownership
der Albtraum	the nightmare
die Bekanntmachung	the notice
die Inspektion	the inspection
der Vorgesetzte	the supervisor
konsultieren	consult
die Arena	the arena
das Lachen	the laugh
die Diagnose	the diagnosis
der Besitz	the possession
verzeihen	forgive
konsequent	consistently
der Keller	the basement
Projekt	project
Drift	drift
ablassen	drain
die Staatsanwaltschaft	the prosecution
maximal	maximum
die Ankündigung	the announcement
der Krieger	the warrior
die Vorhersage	the prediction
die Bakterien	the bacteria
der Fragebogen	the questionnaire
der Schlamm	the mud
die Infrastruktur	the infrastructure
Eile	hurry
das Privileg	the privilege
der Tempel	the temple
Mittel	medium
draussen	outdoor
saugen	suck
und / oder	and/or
die Sendung	the broadcast
Re	re
Sprung	leap
zufällig	random
das Handgelenk	the wrist
der Vorhang	the curtain
der Monitor	the monitor
der Teich	the pond
die Domain	the domain
die Schuld	the guilt
das Vieh	the cattle
Gegenstand	subject
der gehende	the walking
die Playoff	the playoff
Minimum	minimum
der Rock	the skirt
Müllhalde	dump
daher	hence
die Datenbank	the database
unbequem	uncomfortable
ausführen	execute
die Schenkel	the limb
die Ideologie	the ideology
Melodie	tune
auch weiterhin	continuing
der Schaden	the harm
die Eisenbahn	the railroad
ertragen	endure
die Strahlung	the radiation
das Horn	the horn
chronisch	chronic
friedlich	peaceful
die Innovation	the innovation
die Gitarre	the guitar
der Ersatz	the replacement
sich verhalten	behave
verwalten	administer
gleichzeitig	simultaneously
der Tänzer	the dancer
die Änderung	the amendment
bewachen	guard
das Polster	the pad
die Übertragung	the transmission
erwarten	await
im Ruhestand	retired
auslösen	trigger
verschütten	spill
dankbar	grateful
die Gnade	the grace
virtuell	virtual
Antwort	response
die Kolonie	the colony
die Adoption	the adoption
die Rutsche	the slide
einheimisch	indigenous
geschlossen	closed
überführen	convict
die zivile	the civilian
das Handtuch	the towel
die Partikel	the particle
vergeben	award
der Blick	the glance
der Preis	the prize
die Landung	the landing
das Verhalten	the conduct
das Blaue	the blue
Auftrieb	boost
die Fledermaus	the bat
der Alarm	the alarm
das Fest	the festival
der Griff	the grip
seltsam	weird
untergraben	undermine
der Neuling	the freshman
der Schweiß	the sweat
äußere	outer
das Europäische	the European
betrunken	drunk
Umfrage	survey
Forschung	research
die Trennung	the separation
traditionell	traditionally
Sachen	stuff
regieren	govern
der Südosten	the southeast
intelligent	intelligent
wo auch immer	wherever
die Abstimmung	the ballot
die Rhetorik	the rhetoric
überzeugt	convinced
Fahren	driving
das Vitamin	the vitamin
die Begeisterung	the enthusiasm
unterbringen	accommodate
loben	praise
verletzen	injure
die Wildnis	the wilderness
endlos	endless
das Mandat	the mandate
die Pause	the pause
die Entschuldigung	the excuse
beziehungsweise	respectively
die Unsicherheit	the uncertainty
das Chaos	the chaos
mechanisch	mechanical
die Leinwand	the canvas
vierzig	forty
die Lobby	the lobby
das Format	the format
die Währung	the currency
der Truthahn	the turkey
die Reserve	the reserve
der Strahl	the beam
Missbrauch	abuse
der Astronom	the astronomer
die Korruption	the corruption
der Dienstleister	the contractor
entschuldigen	apologize
die Lehre	the doctrine
Original	genuine
der Daumen	the thumb
die Einheit	the unity
der Kompromiss	the compromise
schrecklich	horrible
Verhaltens	behavioral
exklusiv	exclusive
streuen	scatter
vermitteln	convey
der Ansturm	the rush
Twist	twist
die Komplexität	the complexity
die Gabel	the fork
die Scheibe	the disk
entlasten	relieve
der Verdacht	the suspicion
das Schloss	the lock
das Ende	the finish
die Residenz	the residence
die Schande	the shame
sinnvoll	meaningful
der Bürgersteig	the sidewalk
die Olympischen Spiele	the Olympics
technologisch	technological
die Unterschrift	the signature
angenehm	pleasant
Beeindruckend	wow
aussetzen	suspend
der Rebell	the rebel
gefroren	frozen
Verlangen	desire
der Ehegatte	the spouse
die Flüssigkeit	the fluid
die Rente	the pension
fortsetzen	resume
theoretisch	theoretical
das Natrium	the sodium
der Schlag	the blow
Beförderung	the promotion
zart	delicate
die Stirn	the forehead
wieder aufbauen	rebuild
prallen	bounce
elektrisch	electrical
der Haken	the hook
der Detektiv	the detective
der Reisende	the traveler
klicken	click
die Entschädigung	the compensation
Signal	signal
der Ausgang	the exit
die Attraktion	the attraction
widmen	dedicate
insgesamt	altogether
der Ladewagen	the pickup
schnitzen	carve
die Nadel	the needle
der Bauch	the belly
Schiff	ship
Schrecken	scare
das Portfolio	the portfolio
das Shuttle	the shuttle
unsichtbar	invisible
das Timing	the timing
die Verlobung	the engagement
der Knöchel	the ankle
die Transaktion	the transaction
Rettung	rescue
das Gegenstück	the counterpart
mild	mild
der Fahrer	the rider
die Puppe	the doll
der Mittag	the noon
die Ausstellung	the exhibit
inmitten	amid
identisch	identical
präzise	precise
Ängstlich	anxious
strukturell	structural
Wohn	residential
diagnostizieren	diagnose
das Kohlenhydrat	the carbohydrate
die Freiheit	the liberty
das Poster	the poster
die Theologie	the theology
gemeinnützig	nonprofit
kriechen	crawl
der Sauerstoff	the oxygen
gut aussehend	handsome
die Magie	the magic
die Summe	the sum
unter der Voraussetzung	provided
der Geschäftsmann	the businessman
viel versprechend	promising
bewusst	conscious
die Entschlossenheit	the determination
der Spender	the donor
ihres	hers
der Pfarrer	the pastor
der Jazz	the jazz
die Oper	the opera
die Japaner	the Japanese
der Biss	the bite
Rahmen	frame
böse	evil
der Erwerb	the acquisition
die Grube	the pit
Umarmung	hug
das wilde Leben	the wildlife
bestrafen	punish
der Riese	the giant
der primäre	the primary
das Eigenkapital	the equity
die Tür	the doorway
die Abfahrt	the departure
der Aufzug	the elevator
Teenager	teenage
die Fröhlichkeit	the happiness
die Statue	the statue
die Verfolgung	the pursuit
die Reparatur	the repair
anständig	decent
das Fitnesscenter	the gym
Oral	oral
der Angestellte	the clerk
die israelische	the Israeli
der Briefumschlag	the envelope
die Meldung	the reporting
die Faust	the fist
billig	endorse
die Erforschung	the exploration
großzügig	generous
das Bad	the bath
die Rettung	the rescue
der Indikator	the indicator
das Sonnenlicht	the sunlight
die Rückmeldung	the feedback
das Spektrum	the spectrum
lila	purple
der Laser	the laser
Fett gedruckt	bold
widerstrebend	reluctant
Ausgangs	the starting
das Know-how	the expertise
praktisch	practically
Programm	program
Bild	picture
die Melodie	the tune
das Essen	the eating
Alter	age
Freiwillige	volunteer
der Hinweis	the hint
scharf	sharply
die Parade	the parade
befürworten	advocate
das Reich	the realm
das Verbot	the ban
Streifen	strip
stornieren	cancel
Mischung	blend
der Therapeut	the therapist
Scheibe	slice
schälen	peel
die Pizza	the pizza
der Empfänger	the recipient
zögern	hesitate
Flip	flip
die Buchhaltung	the accounting
Debatte	debate
die Bias	the bias
huh	huh
die Metapher	the metaphor
die Kerze	the candle
der Griff	the handle
die Sorge	the worry
Justiz	judicial
das Leiden	the suffering
Vollzeit	full-time
die Lampe	the lamp
der Müll	the garbage
der Diener	the servant
die Zugabe	the addition
Regulierungs	regulatory
diplomatisch	diplomatic
elegant	elegant
das Innere	the inside
die Rezeption	the reception
verschwinden	vanish
automatisch	automatically
das Kinn	the chin
die Notwendigkeit	the necessity
bekennen	confess
der Rassismus	the racism
der Beginner	the starter
Innere	interior
das Banken	the banking
beiläufig	casual
die Schwerkraft	the gravity
einschreiben	enroll
verringern	diminish
die Prävention	the prevention
die arabischen	the Arab
Wert	value
minimieren	minimize
hacken	chop
der Darsteller	the performer
isolieren	isolate
Pumpe	pump
das Inventar	the inventory
produktiv	productive
die Versammlung	the assembly
bürgerlich	civic
die Seide	the silk
die Größenordnung	the magnitude
steil	steep
die Geisel	the hostage
der Sammler	the collector
die Beliebtheit	the popularity
der Kuss	the kiss
das Alien	the alien
dynamisch	dynamic
unheimlich	scary
die gleichung	the equation
der Engel	the angel
der Schalter	the switch
das Angebot	the offering
die Wut	the rage
die Fotografie	the photography
Reparatur	repair
die Toilette	the toilet
enttäuscht	disappointed
kostbar	precious
verbieten	prohibit
Vertreter	representative
Inhalt	content
realistisch	realistic
der Russe	the Russian
versteckt	hidden
Befehl	command
zärtlich	tender
die wake	the wake
die Versammlung	the gathering
hervorragend	outstanding
stolpern	stumble
einsam	lonely
das Automobil	the automobile
künstlich	artificial
die Morgendämmerung	the dawn
abstrakt	abstract
absteigen	descend
dumm	silly
Haken	hook
die Gezeiten	the tide
gemeinsam genutzt	shared
hoffnungsvoll	hopefully
kooperieren	cooperate
Revolutionär	revolutionary
die Romanze	the romance
die Hardware	the hardware
das Kissen	the pillow
der Koch	the cook
die Verbreitung	the spread
der Kontinent	the continent
Dichtung	seal
die Rennbahn	the circuit
das Waschbecken	the sink
die Regelung	the ruling
der Mangel	the shortage
jährlich	annually
in letzter Zeit	lately
die Falle	the trap
Scan	scan
der Dummkopf	the fool
die Deadline	the deadline
Rückseite	rear
das Verarbeiten	the processing
die Ranch	the ranch
Küsten	coastal
unternehmen	undertake
leise	softly
Reservieren	reserve
Verbrennung	burning
verbal	verbal
Stammes	tribal
lächerlich	ridiculous
automatisch	automatic
der Diamant	the diamond
die Glaubwürdigkeit	the credibility
der Import	the import
sexuell	sexually
Frühling	spring
göttlich	divine
die Stimmung	the sentiment
der Wagen	the cart
überwachen	oversee
Stengel	stem
die Ältesten	the elder
die pro	the pro
die Inspiration	the inspiration
Niederländisch	Dutch
die Quantität	the quantity
der Trailer	the trailer
der Steuermann	the mate
Uhr	o'clock
griechisch	Greek
das Genie	the genius
das Monument	the monument
das Streben	the quest
das Opfer	the sacrifice
die Einladung	the invitation
die Genauigkeit	the accuracy
der Juror	the juror
offiziell	officially
der Broker	the broker
der Schatz	the treasure
die Loyalität	the loyalty
Kredit	credit
Schock	shock
talentiert	talented
das Benzin	the gasoline
steif	stiff
die Ausgabe	the output
der Kandidat	the nominee
verlängert	extended
der Diabetes	the diabetes
giftig	toxic
angeblich	alleged
der Kiefer	the jaw
die Trauer	the grief
mysteriös	mysterious
die Rakete	the rocket
spenden	donate
der Insasse	the inmate
angehen	tackle
die Dynamik	the dynamics
der Bogen	the bow
unsere	ours
der Senior	the senior
die Würde	the dignity
der Teppich	the carpet
Eltern	parental
die Blase	the bubble
Hitze	heat
der Kumpel	the buddy
die Scheune	the barn
das Schwert	the sword
der Blitz	the flash
siebte	seventh
die Herrlichkeit	the glory
dicht	tightly
Schutz	protective
stecken	tuck
die Trommel	the drum
Ohnmacht	faint
Post	post
die Königin	the queen
das Dilemma	the dilemma
die Eingabe	the input
sich spezialisieren	specialize
der Nordosten	the northeast
flach	shallow
die Haftung	the liability
Segel	sail
der Händler	the merchant
das Stadium	the stadium
verbessert	improved
blutig	bloody
die Niederlage	the defeat
damit verbundenen	associated
der Rückzug	the withdrawal
der Kühlschrank	the refrigerator
das Nest	the nest
gründlich	thoroughly
die Spur	the lane
Vorfahr	the ancestor
verurteilen	condemn
der Dampf	the steam
der Akzent	the accent
die Flucht	the escape
optimistisch	optimistic
Vereinen	unite
der Käfig	the cage
ausrüsten	equip
die Krabbe	the shrimp
das Heimatland	the homeland
Austausch	exchange
das Regal	the rack
das Kostüm	the costume
der Wolf	the wolf
das Statut	the statute
der Cartoon	the cartoon
die Produktivität	the productivity
Grinsen	grin
symbolisch	symbolic
die Dichtung	the seal
segnen	bless
die Tante	the aunt
die Landwirtschaft	the agriculture
Rock	rock
feindlich	hostile
Wurzel	root
konzipieren	conceive
kombiniert	combined
sofort	instantly
der Konkurs	the bankruptcy
der Impfstoff	the vaccine
der Bonus	the bonus
die Zusammenarbeit	the collaboration
gemischt	mixed
entgegengesetzt	opposed
die Umlaufbahn	the orbit
Griff	grasp
die Geduld	the patience
trotz	spite
tropisch	tropical
die Abstimmung	the voting
die Patrouille	the patrol
die Bereitschaft	the willingness
Position	position
die Offenbarung	the revelation
die Miete	the rent
Ruhe	calm
der Schmuck	the jewelry
kubanisch	Cuban
schleppen	haul
zugeben	concede
die Spur	the trace
der Wagen	the wagon
nachher	afterward
spektakulär	spectacular
Ruine	ruin
schier	sheer
immun	immune
die Verlässlichkeit	the reliability
der Esel	the ass
neben	alongside
der Busch	the bush
exotisch	exotic
faszinierend	fascinating
der Clip	the clip
die Hüfte	the thigh
der Stier	the bull
die Schublade	the drawer
das Schaf	the sheep
entmutigen	discourage
der Koordinator	the coordinator
ideologisch	ideological
der Läufer	the runner
weltlich	secular
intim	intimate
das Reich	the empire
das Taxi	the cab
Scheidung	divorce
die Dokumentation	the documentary
neutral	neutral
die Biologie	the biology
flexibel	flexible
progressiv	progressive
das Netz	the web
die Verschwörung	the conspiracy
der Fang	the catch
der Unfall	the casualty
die Republik	the republic
die Hinrichtung	the execution
großartig	terrific
der Wal	the whale
funktional	functional
Star	star
Entwurf	draft
der Instinkt	the instinct
der Mitspieler	the teammate
das Aluminium	the aluminum
wer auch immer	whoever
das Ministerium	the ministry
das Urteil	the verdict
anweisen	instruct
der Schädel	the skull
das Selbstwertgefühl	the self-esteem
die Leichtigkeit	the ease
Kooperative	cooperative
manipulieren	manipulate
die Biene	the bee
der Praktiker	the practitioner
die Schleife	the loop
bearbeiten	edit
Peitsche	whip
das Puzzle	the puzzle
der Pilz	the mushroom
die Subvention	the subsidy
Kochen	boil
tragisch	tragic
die Mathematik	the mathematics
der Mechaniker	the mechanic
das Gefäss	the jar
das Erdbeben	the earthquake
das Schweinefleisch	the pork
die Kreativität	the creativity
zugrunde liegenden	underlying
das Dessert	the dessert
die Sympathie	the sympathy
der Fischer	the fisherman
unglaublich	incredibly
die Isolierung	the isolation
die Socke	the sock
der Sprung	the jump
elf	eleven
sexy	sexy
der Unternehmer	the entrepreneur
das Syndrom	the syndrome
das Büro	the bureau
Sitz	seat
der Arbeitsplatz	the workplace
der Ehrgeiz	the ambition
die Landung	the touchdown
nutzen	utilize
die Brise	the breeze
teuer	costly
ehrgeizig	ambitious
das Christentum	the Christianity
vermutlich	presumably
einflussreich	influential
die Übersetzung	the translation
unsicher	uncertain
sich auflösen	dissolve
Objekt	object
statistisch	statistical
die Eingeweide	the gut
Metropolitan	metropolitan
Roll	rolling
ästhetisch	aesthetic
buchstabieren	spell
einfügen	insert
die Kabine	the booth
der Helm	the helmet
die Taille	the waist
erwartet	expected
der Löwe	the lion
die Vollendung	the accomplishment
königlich	royal
die Panik	the panic
die Besetzung	the cast
zerquetschen	crush
aktiv	actively
die Klippe	the cliff
minimal	minimal
die Schnur	the cord
glücklicherweise	fortunately
das Kokain	the cocaine
die Illusion	the illusion
anonym	anonymous
tolerieren	tolerate
die Aufwertung	the appreciation
der Kommissar	the commissioner
Schaden	harm
die Flexibilität	the flexibility
Lehr	instructional
Gerangel	scramble
das Casino	the casino
der Tumor	the tumor
schmücken	decorate
Sortieren	sort
der Puls	the pulse
das Äquivalent	the equivalent
erfahren	experienced
die Spende	the donation
das Tagebuch	the diary
das Geschwister	the sibling
die Ironie	the irony
der Löffel	the spoon
die Mitte	the midst
die Gasse	the alley
interagieren	interact
die Seife	the soap
niedlich	cute
der Rivale	the rival
kurzfristig	short-term
der Stecker	the pin
das Hockey	the hockey
Vorbeigehen	passing
fortdauern	persist
der Zulieferer	the supplier
bekannt	known
das Momentum	the momentum
der Geldbeutel	the purse
Schuppen	shed
die Flüssigkeit	the liquid
das Symbol	the icon
der Elefant	the elephant
Folglich	consequently
der Gesetzgeber	the legislature
die Gesellschafter	the associate
das Franchise	the franchise
korrekt	correctly
fördern	foster
das Fahrrad	the bicycle
ermutigend	encouraging
betrügen	cheat
Zugriff	access
heilen	heal
das Fieber	the fever
der Filter	the filter
das Kaninchen	the rabbit
die Münze	the coin
Ausbeuten	exploit
zugänglich	accessible
der Organismus	the organism
die Sensation	the sensation
teilweise	partially
der Aufenthalt	the stay
nach oben	upstairs
getrocknet	dried
das Minimum	the minimum
Profi	pro
die Erhaltung	the conservation
schieben	shove
der Hinterhof	the backyard
die Charta	the charter
der Herd	the stove
die Zustimmung	the consent
umfassen	comprise
die Erinnerung	the reminder
die Platzierung	the placement
der Teig	the dough
der Enkel	the grandchild
der Damm	the dam
wie verlautet	reportedly
sehr bekannt	well-known
Umgebung	surrounding
ökologisch	ecological
das Outfit	the outfit
beispiellos	unprecedented
der Kolumnist	the columnist
das Training	the workout
vorläufig	preliminary
das Patent	the patent
schüchtern	shy
das Zitat	the quote
behindert	disabled
brutto	gross
Verdammt	damn
das Hormon	the hormone
die Textur	the texture
Zähler	counter
der Bleistift	the pencil
der Frontmann	the frontier
das Spray	the spray
die Wette	the bet
bekannt geben	disclose
die Verwahrung	the custody
der Banker	the banker
das Biest	the beast
einmischen	interfere
die Eiche	the oak
Fall	case
achte	eighth
das Notebook	the notebook
Gliederung	outline
Blick	gaze
die Anwesenheit	the attendance
die Spekulation	the speculation
aufdecken	uncover
Namen	behalf
innovativ	innovative
der Hai	the shark
Belohnung	reward
die Mühle	the mill
die Installation	the installation
stimulieren	stimulate
der Tag	the tag
vertikal	vertical
das Schwimmen	the swimming
die Flotte	the fleet
der Katalog	the catalog
der Aussenseiter	the outsider
Opfern	sacrifice
verzweifelt	desperately
die Haltung	the stance
zwingen	compel
die Empfindlichkeit	the sensitivity
irgendwann mal	someday
sofortig	instant
das Debüt	the debut
proklamieren	proclaim
weltweit	worldwide
Wanderung	hike
erforderlich	required
die Konfrontation	the confrontation
bunt	colorful
das Ideal	the ideal
die Verfassung	the constitution
der Trainer	the trainer
die Danksagung	the Thanksgiving
der Duft	the scent
der Stapel	the stack
die Augenbraue	the eyebrow
der Sack	the sack
aufhören	cease
erben	inherit
die Schale	the tray
der Pionier	the pioneer
organisatorisch	organizational
das Textbuch	the textbook
uh	uh
böse	nasty
schrumpfen	shrink
Modell	model
entstehenden	emerging
der Punkt	the dot
das Weizen	the wheat
rational	rational
das Königreich	the kingdom
der Gang	the aisle
schwächen	weaken
das Protokoll	the protocol
ausschließlich	exclusively
Vokal	vocal
der Markt	the marketplace
offen	openly
unfair	unfair
das Gelände	the terrain
einsetzen	deploy
riskant	risky
die Pasta	the pasta
das Genre	the genre
ablenken	distract
das Verdienst	the merit
der Planer	the planner
deprimiert	depressed
der Chunk	the chunk
nächste	closest
der Rabatt	the discount
die Leiter	the ladder
der Dschungel	the jungle
die Migration	the migration
die Atmung	the breathing
einfallen	invade
der Hurricane	the hurricane
der Einzelhändler	the retailer
klassifizieren	classify
Wunde	wound
der Coup	the coup
Hilfe	aid
der Botschafter	the ambassador
die Dichte	the density
stützend	supportive
die Neugier	the curiosity
überspringen	skip
die Aggression	the aggression
der Reiz	the stimulus
der Journalismus	the journalism
der Roboter	the robot
Flut	flood
tauchen	dip
Gleichfalls	likewise
informell	informal
persisch	Persian
die Feder	the feather
die Sphäre	the sphere
spannen	tighten
Prahlerei	boast
klopfen	pat
wahrgenommen	perceived
die Werbung	the publicity
der Bürgermeister	the major
entfalten	unfold
Scherz	joke
das Wohlergehen	the well-being
die Gültigkeit	the validity
das Ökosystem	the ecosystem
streng	strictly
der Kragen	the collar
das Gras	the weed
die Einhaltung	the compliance
der Streifen	the streak
angeblich	supposedly
hinzugefügt	added
der Bauarbeiter	the builder
die Voraussetzung	the premise
die Spezialität	the specialty
erachten	deem
das Artefakt	the artifact
schleichen	sneak
der Affe	the monkey
der Mentor	the mentor
zwei Drittel	two-thirds
der Zuhörer	the listener
der Blitz	the lightning
rechtlich	legally
der Ärmel	the sleeve
die Enttäuschung	the disappointment
stören	disturb
die Rippe	the rib
überhöht	excessive
Hightech	high-tech
die Trümmer	the debris
Haufen	pile
die Stange	the rod
logisch	logical
die liberale	the liberal
die Asche	the ash
sozial	socially
die Pfarrei	the parish
die Sklaverei	the slavery
leer	blank
die Ware	the commodity
die Heilung	the cure
das Mineral	the mineral
der Hunger	the hunger
sterbend	dying
Entwicklungs	developmental
schneller	faster
schonen	spare
auf halber Strecke	halfway
heilen	cure
die Gleichheit	the equality
der Friedhof	the cemetery
die Belästigung	the harassment
die Berühmtheit	the fame
Bedauern	regret
auffallend	striking
die Wahrscheinlichkeit	the likelihood
die Karotte	the carrot
oben auf	atop
die Maut	the toll
der Rand	the rim
verlegen	embarrassed
Ficken	fucking
haften	cling
isoliert	isolated
blinken	blink
verdächtig	suspicious
der Rollstuhl	the wheelchair
berechtigt	eligible
der Prozessor	the processor
stürzen	plunge
der Sponsor	the sponsor
das Grinsen	the grin
Farbe	color
demographisch	demographic
Regen	rain
die Kälte	the chill
die Zuflucht	the refuge
steuern	steer
der Gesetzgeber	the legislator
die Rallye	the rally
die Programmierung	the programming
jubeln	cheer
der Abfluss	the outlet
intakt	intact
der Verkäufer	the vendor
gedeihen	thrive
die Erdnuss	the peanut
kauen	chew
erarbeiten	elaborate
der Intellektuelle	the intellectual
die Konzeption	the conception
die Auktion	the auction
das Steak	the steak
erfüllen	comply
der Triumph	the triumph
der Aktionär	the shareholder
vergleichbar	comparable
Transport	transport
das Gewissen	the conscience
die Berechnung	the calculation
das Intervall	the interval
kratzen	scratch
Erwachen	awake
die Zuständigkeit	the jurisdiction
zwangsläufig	inevitably
Feminist	feminist
die Einschränkung	the constraint
emotional	emotionally
die Expedition	the expedition
Kompromiss	compromise
Belastung	strain
die Ähnlichkeit	the similarity
der Hintern	the butt
der Deckel	the lid
Dumm	dumb
der Großteil	the bulk
streuen	sprinkle
die Sterblichkeit	the mortality
philosophisch	philosophical
die Umwandlung	the conversion
der Patron	the patron
Stadt	municipal
die Leber	the liver
die Harmonie	the harmony
einzig und allein	solely
die Toleranz	the tolerance
der Moment	the instant
die Ziege	the goat
Arm	arm
der Segen	the blessing
die Banane	the banana
das Laufen	the running
der Palast	the palace
früher	formerly
der Bauer	the peasant
ordentlich	neat
der Supermarkt	the supermarket
die Kreuzfahrt	the cruise
die Ebene	the plain
der Kalender	the calendar
die Witwe	the widow
die Anzahlung	the deposit
der Bart	the beard
die Bremse	the brake
das Screening	the screening
der Impuls	the impulse
verbieten	forbid
das Fell	the fur
brutal	brutal
der Räuber	the predator
Sack	poke
opt	opt
freiwillig	voluntary
Ärger	trouble
gültig	valid
das Forum	the forum
das Tanzen	the dancing
steigen	soar
die Beseitigung	the removal
die Autonomie	the autonomy
erlassen	enact
der Faden	the thread
das Wahrzeichen	the landmark
unzufrieden	unhappy
der Täter	the offender
Kommen	coming
privat	privately
unverwechselbar	distinctive
der Tourismus	the tourism
der Grenzbereich	the threshold
routinemäßig	routinely
die Suite	the suite
Anmerkung	remark
der Regler	the regulator
der Strohhalm	the straw
theologisch	theological
Auspuff	exhaust
der Globus	the globe
zerbrechlich	fragile
der Einwand	the objection
die Chemie	the chemistry
altmodisch	old-fashioned
überfüllt	crowded
Kreis	circle
die Explosion	the blast
herrschen	prevail
über Nacht	overnight
die Verweigerung	the denial
die Miete	the rental
Fantastisch	fantastic
das Fragment	the fragment
Niveau	level
Schraube	screw
die Wärme	the warmth
die Bachelor	the undergraduate
Flüssigkeit	liquid
die Kopfschmerzen	the headache
der Polizist	the policeman
die Ausbeute	the yield
der Vorsprung	the projection
Schlacht	battle
geeignet	suitable
die Erwähnung	the mention
der Schulabschluss	the graduation
bohren	drill
grausam	cruel
die Villa	the mansion
der Bezug	the regard
die Traube	the grape
autorisieren	authorize
die Hütte	the cottage
die Auffahrt	the driveway
der Charm	the charm
die Sexualität	the sexuality
treu	loyal
der Ton	the clay
Pfund	pound
der Ballon	the balloon
die Erfindung	the invention
das Ego	the ego
der Fahrpreis	the fare
die Hausaufgabe	the homework
das Sofa	the sofa
die Garantie	the guarantee
die Verfügbarkeit	the availability
das Radar	the radar
Stirnrunzeln	frown
wiedergewinnen	regain
das Verlassen	the leave
die Genehmigung	the permit
der Pullover	the sweater
die Rehabilitation	the rehabilitation
Gummi	rubber
der Rückzug	the retreat
das Molekül	the molecule
günstig	favorable
ständig	steadily
Veteran	veteran
integriert	integrated
Ha	ha
der Youngster	the youngster
Übertragung	broadcast
das Bessere	the premium
die Rechenschaftspflicht	the accountability
überwältigen	overwhelm
ein Drittel	one-third
aktualisieren	update
Funke	spark
ironisch	ironically
die Müdigkeit	the fatigue
spekulieren	speculate
der Marker	the marker
predigen	preach
der Eimer	the bucket
Bombe	bomb
blond	blond
das Geständnis	the confession
provozieren	provoke
der Marmor	the marble
im Wesentlichen	substantially
die Verwindung	the twist
der Verteidiger	the defender
Fisch	fish
explizit	explicit
der Transport	the transport
störend	disturbing
die Überwachung	the surveillance
magnetisch	magnetic
der Techniker	the technician
murmeln	mutter
verheerend	devastating
abfahren	depart
der Pfeil	the arrow
das Trauma	the trauma
Nachbar	neighboring
einweichen	soak
das Farbband	the ribbon
die Zwischenzeit	the meantime
übertragen	transmit
Bildschirm	screen
die Ernte	the harvest
aufeinanderfolgenden	consecutive
Republikaner	republican
Koordinate	coordinate
der Spion	the spy
der Schlitz	the slot
der Aufstand	the riot
der Nährstoff	the nutrient
die Staatsbürgerschaft	the citizenship
die Souveränität	the sovereignty
der Grat	the ridge
mutig	brave
die Beleuchtung	the lighting
angeben	specify
der Beiträger	the contributor
vereiteln	frustrate
Menge	crowd
artikulieren	articulate
wichtig	importantly
der Transit	the transit
dicht	dense
das Seminar	the seminar
die Elektronik	the electronics
sonnig	sunny
die Shorts	the shorts
anschwellen	swell
der Vorwurf	the accusation
erweichen	soften
Foto	photograph
begradigen	straighten
fürchterlich	terribly
der Cue	the cue
die Braut	the bride
die Biographie	the biography
die Gefahr	the hazard
zwingend	compelling
die Fliese	the tile
wirtschaftlich	economically
ehrlich	honestly
beunruhigt	troubled
Bogen	bow
zwanzigste	twentieth
ausgewogen	balanced
der Ausländer	the foreigner
der Start	the launch
die Annehmlichkeit	the convenience
weben	weave
das Holz	the timber
der Klagegrund	the plea
die Glühbirne	the bulb
Kopieren	copy
fliegend	flying
nachhaltig	sustainable
der Teufel	the devil
die Fracht	the cargo
die Wirbelsäule	the spine
der Verkäufer	the seller
Fach	skilled
Verwaltung	managing
Marine	marine
das Dock	the dock
organisiert	organized
der Nebel	the fog
der Diplomat	the diplomat
langweilig	boring
irgendwann	sometime
die Zusammenfassung	the summary
der Missionar	the missionary
die Epidemie	the epidemic
tödlich	fatal
trimmen	trim
das Warenhaus	the warehouse
beschleunigen	accelerate
der Schmetterling	the butterfly
die Bronze	the bronze
ertrinken	drown
inhärent	inherent
das Lob	the praise
landesweit	nationwide
spucken	spit
Ernte	harvest
knien	kneel
das Vakuum	the vacuum
ausgewählt	selected
diktieren	dictate
das Klischee	the stereotype
der Sensor	the sensor
die Wäscherei	the laundry
das Handbuch	the manual
die Pistole	the pistol
marine	naval
der Kläger	the plaintiff
die Mittelklasse	the middle-class
die Entschuldigung	the apology
der Man	the man
das Ding	the thing
die Raum	the room
die Ehefrau	the wife
das Los	the lot
die Anzahl	the number
der Beutel	the bag
die Rast	the rest
die Mama	the mom
die Sir	the sir
der Brief	the letter
die Wohnung	the apartment
der Fels	the rock
die Kleider	the clothes
das Gedächtnis	the memory
die Reiß	the tear
der Schüler	the student
die Sehenswürdigkeit	the sight
der Erzähler	the narrator
der Offizier	the officer
der Wächter	the guard
die Bit	the bit
dunkelheit	the darkness
der Fehl	the miss
das College	the college
norden	the north
das Geräusch	the noise
die Mama	the mama
der Herr	the lord
der Papa	the daddy
der Platz	the spot
das Maximum	the maximum
die Gate	the gate
die Vorhalle	the porch
das Schwimmbecken	the pool
staub	the dust
wein	the wine
die Bob	the bob
der Club	the club
sturm	the storm
die Türöffnung	the doorway
die Hose	the pant
das Erlebnis	the experience
das Camp	the camp
der Strahl	the ray
die Volks	the folk
der Knopf	the button
das Level	the level
die Runden	the lap
das Magazin	the magazine
der Ast	the branch
das Auf Wiedersehen	the goodbye
das Park	the parking
das Gelächter	the laughter
der Verfasser	the writer
die Gardine	the curtain
das Rudel	the pack
die Lilie	the lily
den Artikel	the article
die Lauf	the run
das Weinen	the cry
die Instant	the instant
das Publikum	the audience
die Jahreszeit	the season
der Klient	the client
der Prinz	the prince
dem Kunden	the customer
die Emotion	the emotion
der Grad	the degree
das Begräbnis	the funeral
der Oberschenkel	the thigh
der Buck	the buck
die Ziegel	the brick
die Hülse	the sleeve
der Speisesaal	the dining
der Drache	the dragon
der Umschlag	the envelope
die Erwachsene	the adult
das Kopfnicken	the nod
die Robe	the robe
der Stil	the style
die Kreis	the county
der Schrei	the scream
die Bitch	the bitch
der Seufzer	the sigh
der Messestand	the booth
das TShirt	the tshirt
das Flüstern	the whisper
die Hank	the hank
das Glied	the limb
der Bastard	the bastard
das Rotkehlchen	the robin
die Justiz	the justice
der Sekretär	the secretary
der Sheriff	the sheriff
die Mitternachts	the midnight
den Wecker	the alarm
die Kiefer	the pine
die Papa	the papa
die Perle	the pearl
die Prinzessin	the princess
das Getriebe	the gear
der Koffer	the suitcase
das Atem	the breathing
der Gefangene	the prisoner
die Burg	the castle
die Fahrspur	the lane
zum Teufel	the fuck
der Hase	the rabbit
der Bereich	the range
die Dick	the dick
die Reflexion	the reflection
die Baseball	the baseball
der Schrecken	the terror
die Buster	the buster
der Wachtmeister	the sergeant
die Bedrohung	the threat
dem Vorabend	the eve
den Titel	the title
das Messgerät	the meter
der Umstand	the circumstance
der Sieger	the victor
die Oma	the grandma
das Glühen	the glow
die Slave	the slave
der Leutnant	the lieutenant
der Maurer	the mason
das Gehen	the walking
die Leiche	the corpse
das Pad	the pad
der Rubin	the ruby
der Oberst	the colonel
der Bach	the creek
die Gunst	the favor
der Dekan	the dean
der Marsch	the march
der Ständige	the standing
der Dämon	the demon
der Pinsel	the brush
die Haube	the hood
der Heilige	the saint
die Angel	the fishing
der Graf	the earl
der Kellner	the waiter
von Lebensmittel	the grocery
das Volumen	the volume
das Ass	the ace
die Phantasie	the imagination
die Schwarze	the black
der Reed	the reed
der Wanderer	the walker
der Ansatz	the approach
die Narbe	the scar
die Tritt	the footstep
der Aufnehmer	the pickup
der Habicht	the hawk
der Anhänger	the trailer
der Käfer	the bug
den Urlaub	the vacation
der Urheberrechts	the copyright
die China	the china
die Durchschnitts	the mean
die Druck	the print
der Idiot	the idiot
der Bulle	the bull
die Saat	the seed
das Versagen	the failure
die Taschenlampe	the flashlight
der Seemann	the sailor
das Weinen	the crying
die Sip	the sip
die Dämmerung	the dusk
das Makeup	the makeup
die Doc	the doc
die Bluse	the blouse
der Bolzen	the bolt
die Klopf	the knock
der Zauber	the spell
die Luke	the hatch
das Dienstmädchen	the maid
die Relative	the relative
die Hexe	the witch
die Locke	the curl
die Kellnerin	the waitress
der Hammer	the hammer
die Indische	the indian
der Balkon	the balcony
der Knoten	the knot
die Stare	the stare
das Motel	the motel
der Liebling	the darling
der Strang	the strand
die Mittags	the noon
die Vene	the vein
der Fuchs	the fox
die Impuls	the pulse
der Kies	the gravel
die Zigarre	the cigar
die Braune	the brown
der Schal	the scarf
die Klaue	the claw
der Cowboy	the cowboy
das Jagd	the hunting
das Pat	the pat
die Bildung	the education
der Schuppen	the shed
der Herzog	the duke
die Schrotflinte	the shotgun
es Gibt	the rear
die Wanne	the tub
die Iris	the iris
die Zugriffs	the access
erz	the brass
die Seitenleiste	the sidebar
der Rumpf	the hull
die Lappen	the rag
das Gute	the good
der Gigant	the giant
die Serviette	the napkin
die Wäsche	the laundry
der Opa	the grandpa
die Einkaufshalle	the mall
der Ford	the ford
die Krähe	the crow
die Selbstmord	the suicide
der Sonnenuntergang	the sunset
der Donner	the thunder
der Whisky	the whiskey
der Klick	the click
der Müller	the miller
die Ruhe	the calm
der Deutsche	the german
der Mönch	the monk
der Wurm	the worm
die Traurigkeit	the sadness
die Tänzerin	the dancer
die Matratze	the mattress
die Ad	the ad
der Becher	the mug
das Kit	the kit
das Gebrüll	the roar
die Truppe	the troop
der Sarg	the coffin
der Krankenwagen	the ambulance
das Mondlicht	the moonlight
die Hosen	the trousers
die Wolle	the wool
die Mac	the mac
der Dieb	the thief
die Aktentasche	the briefcase
das Mitleid	the pity
die Finger	the fingertip
die Marine	the navy
das Gen	the gene
die Windschutzscheibe	the windshield
der Shuttle	the shuttle
das Unkraut	the weed
die Pfote	the paw
die Festung	the fort
das Plakat	the poster
der Vampir	the vampire
das Arschloch	the asshole
der Gurt	the strap
das Wohnzimmer	the parlor
den Mist	the crap
die Falte	the fold
das Maß	the measure
der Ritter	the knight
der Brunnen	the fountain
der Stall	the stall
der Funke	the spark
der Champagner	the champagne
das Violett	the violet
das Trink	the drinking
das Taschentuch	the handkerchief
das Parfüm	the perfume
der Anspruch	the claim
die Nonne	the nun
die Krone	the crown
das Geländer	the railing
die Barmherzigkeit	the mercy
das Schließfach	the locker
die Burst	the burst
der Frosch	the frog
der Jeep	the jeep
der Bogenschütze	the archer
der Hirte	the shepherd
die Madame	the madame
der Schrott	the scrap
der Wulst	the bead
die Blendung	the glare
das Cafe	the cafe
das Pochen	the pounding
die Schlucht	the canyon
die Spinne	the spider
der Fluch	the curse
das Treppenhaus	the staircase
der Drang	the urge
die Sirene	the siren
das Leer	the curb
der Pirat	the pirate
der Liebe	the dear
die Politik	the politics
der Tennis	the tennis
die Zugehörigkeit	the affiliation
das Momma	the momma
der Umhang	the cape
der Scheinwerfer	the headlight
die Sauerstoff	the oxygen
der Fingernagel	the fingernail
der Weinstock	the vine
der Barkeeper	the bartender
der Koks	the coke
der Rabbi	the rabbi
die Begrüßung	the greeting
die Homer	the homer
der Kamin	the fireplace
das Trikot	the jersey
die Pop	the pop
das Gasthaus	the inn
der Stellvertretende	the deputy
die Verzweiflung	the despair
die Jazz	the jazz
die Umarmung	the hug
die Pfeife	the whistle
das Tageslicht	the daylight
der Slip	the slip
die Rüstung	the armor
der Rucksack	the backpack
das Nasenloch	the nostril
der Speer	the spear
das Kalb	the calf
der Fund	the discovery
die Kraftstoff	the fuel
die Unterwäsche	the underwear
die Kuppel	the dome
die Neigung	the affection
das Wohnzimmer	the lounge
die Achselzucken	the shrug
die Kohlen	the coal
die Jagd	the chase
der Klumpen	the lump
die Zahlung	the pay
die UBahn	the subway
die Kirsche	the cherry
die Eile	the hurry
die Geliebte	the mistress
der Unsinn	the nonsense
das Echo	the echo
der Durchhang	the slack
die Decker	the decker
der Toast	the toast
der Schnurrbart	the mustache
das Augenlid	the eyelid
die Chunk	the chunk
die Schildkröte	the turtle
die Gummi	the gum
der Prediger	the preacher
der Dolly	the dolly
das Leinen	the linen
der Heap	the heap
die Schürze	the apron
das Graue	the gray
der Ekel	the disgust
die Flotte	the liquor
der Lippenstift	the lipstick
der Container	the container
die Hure	the whore
das Kleinkind	the infant
die Sonnenbrille	the sunglasses
der Schlauch	the hose
das Bullshit	the bullshit
das Fach	the compartment
der Backofen	the oven
das Korn	the grain
das Picknick	the picnic
die Knospe	the bud
die Wiese	the meadow
das Gift	the poison
der Büffel	the buffalo
die Soda	the soda
die Eule	the owl
der Kick	the kick
die Ruine	the ruin
die Rampe	the ramp
unterarm	the forearm
der Achsschenkel	the knuckle
die Gans	the goose
der Vormarsch	the advance
die Fee	the fairy
die Mannschaft	the squad
die Orgel	the organ
der Unglaube	the disbelief
der Hain	the grove
der Sattel	the saddle
die Cluster	the cluster
der Abzug	the trigger
der Welpe	the puppy
die Warte	the waiting
die Kommode	the dresser
der Adler	the eagle
der Privatsphäre	the privacy
das Fluid	the fluid
die Herde	the herd
der Kopfschmerz	the headache
der Vergnügungspark	the amusement
das Belle	the belle
die Tabak	the tobacco
die Tätowierung	the tattoo
der Fleck	the stain
der Regenschirm	the umbrella
der Kaiser	the emperor
der Pier	the pier
der Wasserhahn	the tap
der Cutter	the cutter
der Dachboden	the attic
der Tiger	the tiger
die Pal	the pal
der Vorfahr	the ancestor
die Leiste	the ledge
die Fackel	the torch
die Tinten	the ink
das Maultier	the mule
das Stirnrunzeln	the frown
die Mitten	the midst
die Verlegenheit	the embarrassment
das Spannfutter	the chuck
die Clearing	the clearing
die Halskette	the necklace
die Laterne	the lantern
das Lamm	the lamb
die Schritt	the stride
die Manschette	the cuff
die Jungfrau	the virgin
das Eichhörnchen	the squirrel
der Star	the starling
das Speicher	the storage
der Altar	the altar
die Bogen	the arc
das Juwel	the jewel
die Junk	the junk
der Sonnenschein	the sunshine
der Knabe	the lad
der Elf	the elf
das Aspekt	the aspect
das Zifferblatt	the dial
der Hausschuh	the slipper
der Ohrring	the earring
die Ameise	the ant
die Patty	the patty
die Sauce	the sauce
der Graben	the ditch
das Gänseblümchen	the daisy
die Kapelle	the chapel
der Sumpf	the swamp
die Vermutung	the guess
der Kran	the crane
das Diner	the diner
das Skelett	the skeleton
das Elend	the misery
der Stumpf	the stump
der Einsatz	the stake
die Puff	the puff
das Gefolge	the wake
der Zauberer	the wizard
die Matte	the mat
das Zwielicht	the twilight
das Grunzen	the grunt
der Clan	the clan
das Kupfer	the copper
das Steuer	the steering
das Bedauern	the regret
die Romantik	the romance
die Terrasse	the patio
die Schaufel	the shovel
die Schlafanzüge	the pajamas
die Email	the email
die Taube	the pigeon
der Dinosaurier	the dinosaur
der Lift	the lift
das Küken	the chick
das Diagramm	the chart
der Lorbeer	the laurel
der Bluterguss	the bruise
der Knopf	the knob
der Frost	the frost
der Nippel	the nipple
der Pfarrer	the reverend
die Trübung	the haze
das Weihnachtslied	the carol
der Metzger	the butcher
der Würfel	the cube
der Hohl	the hollow
der Höcker	the bump
das Heu	the hay
die Rinde	the bark
die Überlebens	the survival
die Etagen	the bunk
die Biegung	the bend
der Cocktail	the cocktail
das Paradies	the paradise
das Rasiermesser	the razor
die Blüte	the blossom
die Pfütze	the puddle
die Laser	the laser
der Zement	the cement
die Gelbe	the amber
die Göttin	the goddess
die Drift	the drift
die Kämpfe	the fighting
das Geflecht	the braid
der Clown	the clown
die Brille	the goggle
der Pfirsich	the peach
die Wasch	the wash
die Befreiung	the release
die Tag	the tag
der Bh	the bra
die Terrasse	the terrace
die Überbleibsel	the remains
der Joint	the joint
der Diplom	the graduate
der Chor	the chorus
die Rache	the revenge
der Platz	the plaza
der Ältere	the elder
der Ingwer	the ginger
der Bindestrich	the dash
die Sandale	the sandal
der Hass	the hatred
der Umriss	the outline
der Rabe	the raven
die Vorfreude	the anticipation
feier	the celebration
die Qual	the agony
die Turnschuhe	the sneakers
das Terminal	the terminal
die Weide	the pasture
die Konsole	the console
das Abzeichen	the badge
der Fonds	the fund
das Foyer	the foyer
der Pastor	the pastor
die Umarmung	the embrace
der Applaus	the applause
der Graben	the trench
die Bis	the up
der Neffe	the nephew
der Mix	the mix
der Mob	the mob
die Güte	the goodness
der Scout	the scout
die Beihilfen	the aid
das Mikrofon	the microphone
der Kojote	the coyote
der Brennvorgang	the burn
die Weste	the vest
das Pony	the pony
das Keuchen	the gasp
das Zögern	the hesitation
die Taverne	the tavern
die Lästige Pflicht	the chore
das Segel	the sail
die Silhouette	the silhouette
das Institut	the institute
der Lügner	the liar
das Brett	the plank
der Ruck	the jerk
der Strumpf	the stocking
die Schwärze	the blackness
das Armband	the bracelet
gelee	the jelly
der Beton	the concrete
das Banner	the banner
die Haltung	the posture
der Wodka	the vodka
die Bekanntschaft	the acquaintance
der Nap	the nap
der Schleier	the veil
das Schauspiel	the spectacle
die Kopfhaut	the scalp
die Stechpalme	the holly
der Appetit	the appetite
der Efeu	the ivy
die Nichte	the niece
die Verrücktheit	the madness
der Bäcker	the baker
das Virus	the virus
der Ordner	the folder
das Bekenntnis	the confession
der Gepäckträger	the porter
die Müllhalde	the dump
der Tratsch	the gossip
die Stute	the mare
der Rumpf	the torso
der Besen	the broom
der Huf	the hoof
der Speck	the bacon
das Heck	the stern
die Geige	the violin
die Pest	the plague
die Unschärfe	the blur
der Diakon	the deacon
die Lanze	the lance
der Gin	the gin
die Weide	the willow
die Kratz	the scratch
der Verband	the dressing
der Admiral	the admiral
der Regenbogen	the rainbow
die Eidechse	the lizard
der Zwerg	the dwarf
der Vers	the verse
die Überzeugung	the conviction
der Rover	the rover
der Zaunkönig	the wren
die Säulen	the pillar
die Marmelade	the jam
der Schnaps	the brandy
der Baron	the baron
die Wendung	the twist
die Skizze	the sketch
das Register	the register
der Herzschlag	the heartbeat
die Cafeteria	the cafeteria
die Hang	the hillside
das Labyrinth	the maze
das Brummen	the hum
das Kätzchen	the kitten
der Knall	the bang
der Dolch	the dagger
das Con	the con
die Einsamkeit	the loneliness
das Motorrad	the motorcycle
das Staunen	the amazement
die Peer	the peer
die Tech	the tech
die Beleidigung	the insult
die Ehrfurcht	the awe
die Chili	the chili
die Lodge	the lodge
die Limousine	the limo
die Mücke	the mosquito
der Würfel	the dice
der Shake	the shake
das Festmahl	the feast
die Erbse	the pea
das Murmeln	the murmur
der Genosse	the comrade
die Herde	the flock
sob	the sob
das Zusammentreffen	the coincidence
der Waldläufer	the ranger
die Karikatur	the cartoon
der Mitbewohner	the roommate
die Freundlichkeit	the kindness
der Kreuzer	the cruiser
die Bramme	the slab
die Cheer	the cheer
der Konus	the cone
die Schaltung	the circuit
das Elfenbein	the ivory
der Zimmermann	the carpenter
der Penner	the bum
die Donna	the donna
die Krabbe	the crab
das Stöhnen	the groan
die Akademie	the academy
die Sehnsucht	the longing
die Kip	the kip
der Bohrer	the drill
das Gepäck	the luggage
der Baldachin	the canopy
der Nervenkitzel	the thrill
der Sumpf	the marsh
der Schornstein	the chimney
die Anker	the anchor
das Ahorn	the maple
das Kaninchen	the bunny
der Thron	the throne
das Neon	the neon
die Luftschleuse	the airlock
die Ermüdungs	the fatigue
das Manuskript	the manuscript
das Denkmal	the memorial
das Engineering	the engineering
die Linke	the left
die Assoziation	the association
die Beute	the prey
die Taube	the dove
die Episode	the episode
die Kathedrale	the cathedral
die Nach Unten	the down
zum Teufel	the dickens
der Saum	the hem
die Lust	the lust
die Kichern	the giggle
die Klassenkameraden	the classmate
die Reinigung	the cleaning
der Rezeptionist	the receptionist
der Anrufer	the caller
die Verachtung	the contempt
die Großeltern	the grandparent
die Tat	the deed
die Falten	the wrinkle
der Magier	the magician
der Stich	the pang
die Italienische	the italian
die Ewigkeit	the eternity
der Schiefer	the slate
das Treppenhaus	the stairwell
die Vase	the vase
die Oma	the granny
der Außenseiter	the maverick
die Bandage	the bandage
der Schinken	the ham
der Fuhrmann	the carter
die Unschuld	the innocence
die Dach	the rooftop
der Pfannkuchen	the pancake
der Asteroid	the asteroid
die Postkarte	the postcard
das Kleidungsstück	the garment
die Bestimmung	the determination
der Traktor	the tractor
die Beere	the berry
der Klumpen	the clump
die Straftat	the offense
der Butler	the butler
der Husten	the cough
der Granit	the granite
der Wende	the turning
das Kompliment	the compliment
der Karton	the carton
die Türklingel	the doorbell
die Gewissheit	the certainty
die Dankbarkeit	the gratitude
die Jetzige	the current
das Dunkel	the gloom
der Putz	the plaster
die Chop	the chop
die Mordkommission	the homicide
die Aluminium	the aluminum
der Boulevard	the boulevard
der Schüler	the pupil
der Schwimmer	the float
der Schnittpunkt	the intersection
die Leere	the emptiness
der Verlag	the publisher
der Zirkus	the circus
die Abmessung	the dimension
der Tierpark	the zoo
der Bote	the messenger
das Beau	the beau
das Gewirr	the tangle
die Verzweiflung	the desperation
der Abfluss	the drain
die Erdbeere	the strawberry
das Fernglas	the binoculars
die Kluft	the gulf
die Hecke	the hedge
das Stöhnen	the moan
der Verschluss	the shutter
das Floß	the raft
der Arzt	the physician
das Kamel	the camel
das Schlagen	the beating
müsli	the cereal
das Becken	the basin
das Nachthemd	the nightgown
das Cockpit	the cockpit
das Wrack	the wreck
die Perücke	the wig
darin	the rein
der Recorder	the recorder
die Höflichkeit	the courtesy
die Wangenknochen	the cheekbone
die Peitsche	the whip
der Pilger	the pilgrim
der Weise	the sage
der Asphalt	the asphalt
die Süße	the sweetie
der Obstgarten	the orchard
das Kinderbett	the cot
der Beutel	the pouch
das Feuerzeug	the lighter
die Snack	the snack
das Reden	the talking
die Op	the op
die Welligkeit	the ripple
die Radar	the radar
der Pferdeschwanz	the ponytail
die Stoß	the surge
der Erbe	the heir
der Bunker	the vault
die Sissy	the sissy
die Schotten	the scotch
die Tunika	the tunic
der Think	the think
der Penis	the penis
der Einheimische	the native
das Liebesspiel	the lovemaking
die Poker	the poker
der Kalk	the lime
das Überwachungs	the surveillance
der Chopper	the chopper
der Träger	the carrier
das Kin	the kin
die Passform	the fit
die Pull	the pull
das Bauernhaus	the farmhouse
das Warten	the wait
der Attentäter	the assassin
der Schaum	the foam
der Schlepper	the tug
der Abstieg	the descent
das Klingeln	the ringing
die Schere	the scissors
der Zweig	the twig
der Urlaubsort	the resort
der Beschützer	the guardian
der Weizen	the wheat
der Hurrikan	the hurricane
der Spielplatz	the playground
die Tastatur	the keyboard
die Zeder	the cedar
das Wappen	the crest
der Jasmin	the jasmine
der Sessel	the armchair
blinde	the blind
zylinder	the cylinder
die Schwalbe	the swallow
das Dreieck	the triangle
der Gestank	the stench
der Supervisor	the supervisor
die Weite	the expanse
das Moos	the moss
der Sturm	the gale
die Treue	the loyalty
der Lavendel	the lavender
die Begnadigung	the pardon
der Aschenbecher	the ashtray
die Scherbe	the shard
die Ablenkung	the distraction
die Majestät	the majesty
die Pyramide	the pyramid
der Ruhm	the fame
die Not	the distress
der Magier	the mage
der Schwarm	the crush
die Dime	the dime
die Böen	the gust
der Festlichkeit	the treat
der Schläger	the thug
die Steckdose	the socket
der Kürbis	the pumpkin
der Dorn	the thorn
die Wurst	the sausage
die Dig	the dig
der Tan	the tan
der Dorn	the spike
die Krume	the crumb
das Wachs	the wax
das Knurren	the growl
die Vermietung	the rental
das Futter	the feed
die Eskorte	the escort
das Erstaunen	the astonishment
die Flora	the flora
die Blüte	the bloom
das Loft	the loft
das Flimmern	the flicker
der Leibwächter	the bodyguard
die Umsetzung	the realization
der Krater	the crater
das Kongress	the congress
der Braten	the fry
das Zittern	the shiver
der Verlierer	the loser
die Zuzwinkern	the wink
die Kies	the pebble
der Sonnenaufgang	the sunrise
die Erschöpfung	the exhaustion
der Doppelgänger	the double
der Umfang	the perimeter
der Kamm	the comb
der Spritz	the splash
die Konvention	the convention
die Pose	the pose
die Wiege	the cradle
der Stößel	the ram
der Adel	the gentry
die Naht	the seam
der Punk	the punk
der Überrest	the remnant
der Cracker	the cracker
der Bluff	the bluff
die Düne	the dune
der Zahnarzt	the dentist
die Satin	the satin
das Postfach	the mailbox
der Ärger	the annoyance
das Zischen	the hiss
das Lokal	the local
der Bums	the thud
die Bestürzung	the dismay
der Freak	the freak
der Haarschnitt	the haircut
die Süße	the sweet
die Waise	the orphan
das Schach	the chess
die Blütenblatt	the petal
die Schreibarbeit	the paperwork
der Psychiater	the psychiatrist
der Gesang	the singing
das Interrupt	the interrupt
die Bewunderung	the admiration
das Gefrier	the freezer
die Illustration	the illustration
der Eintopf	the stew
der Ermittler	the investigator
der Vorort	the suburb
das Holster	the holster
die Intimität	the intimacy
die Peitsche	the lash
die Einsparung	the saving
die Henne	the hen
die Birke	the birch
der Kindergarten	the nursery
die Pflaume	the plum
das Nichts	the void
die Kanone	the cannon
die Fransen	the fringe
die Stereo	the stereo
die Fella	the fella
der Pinguin	the penguin
die Folter	the torture
die Briefmarke	the stamp
der Übersetzer	the translator
ostern	the easter
das Einfrieren	the freeze
die Pew	the pew
der Pfropfen	the wad
das Höschen	the panties
der Spieß	the spit
der Kühler	the cooler
der Grill	the grill
der Spitzname	the nickname
der Revolver	the revolver
die Maschinen	the machinery
die Damen Und Herren	the madam
der Hecht	the pike
der Laptop	the laptop
der Schnabel	the beak
die Geschwister	the sibling
der Kleiderschrank	the wardrobe
die Klappe	the flap
der Einzige	the sole
das Mitgefühl	the compassion
die Antennen	the antenna
die Grille	the cricket
der Troll	the troll
der Bücherladen	the bookstore
der Halter	the holder
rücksitz	the backseat
die Unwissenheit	the ignorance
das Korps	the corps
die Einsamkeit	the solitude
die Chemische	the chemical
der Dorfbewohner	the villager
die Perfektion	the perfection
der Papst	the pope
das Semester	the semester
die Untertasse	the saucer
die Dringlichkeit	the urgency
der Vulkan	the volcano
die Würze	the spice
der Chor	the choir
gerichtsgebäude	the courthouse
der Boxer	the boxer
die Besorgung	the errand
wobei der Mechanismus	the mechanism
die Fähre	the ferry
der Nigger	the nigger
der Passant	the passerby
die Reizung	the irritation
die Limousine	the sedan
der Feigling	the coward
die Git	the git
die Fackel	the flare
das Heulen	the howl
die Fang	the fang
die Römisch	the roman
der Farbton	the hue
das Unbehagen	the discomfort
das Entlüftungs	the vent
das Kanu	the canoe
der Hamburger	the hamburger
die Traufe	the eave
der Barbier	the barber
das Ableben	the passing
der Verrat	the betrayal
das Sweatshirt	the sweatshirt
die Tentakel	the tentacle
die Brandung	the surf
das Plaid	the plaid
der Gehweg	the walkway
das Hinken	the limp
die Bequemlichkeit	the convenience
die Windel	the diaper
der Maulwurf	the mole
der Reiniger	the cleaner
die Dünung	the swell
der Erwachsene	the grownup
die Scan	the scan
die Klarheit	the clarity
der Salon	the salon
die Flug	the flying
der Rechtsmittelgrund	the plea
die Prärie	the prairie
die Eitelkeit	the vanity
die Olive	the olive
der Bergmann	the miner
die Sicherungs	the backup
die Gegensprechanlage	the intercom
das Tuch	the shawl
der Plattenteller	the platter
das Poltern	the rumble
der Ansager	the announcer
die Axt	the axe
die Übertragungs	the transmission
die Krippe	the crib
die Sprung	the hop
das Aroma	the aroma
die Walze	the roller
der Transfer	the transfer
der Generator	the generator
die Luxus	the luxury
das Auditorium	the auditorium
der Kobold	the goblin
der Zapfen	the peg
die Probe	the specimen
die Zulassung	the admission
die Besessenheit	the obsession
die Patsy	the patsy
das Wohnheim	the dorm
die Säge	the saw
die Til	the til
der Staffelungs	the stagger
die Fotze	the pussy
die Flocke	the flake
die Silbe	the syllable
das Bouquet	the bouquet
der Schwur	the vow
die Enkelin	the granddaughter
der Aufruhr	the riot
der Burger	the burger
die Plus	the plus
der Spatz	the sparrow
die Botschaft	the embassy
das Podium	the podium
das Herrenhaus	the manor
das Schlurfen	the shuffling
der Delfin	the dolphin
der Wasserkocher	the kettle
der Tierarzt	the vet
die Landebahn	the runway
der Mohn	the poppy
im Obergeschoss	the upstairs
die Lava	the lava
der Busen	the bosom
der Eindringling	the intruder
der Pokal	the trophy
die Eifersucht	the jealousy
der Aufseher	the warden
der Yachthafen	the marina
das Lebewohl	the farewell
die Gegenstände	the belongings
die Prozession	the procession
der Astronaut	the astronaut
die Sweep	the sweep
die Erholung	the recovery
der Kabelbaum	the harness
das Logo	the logo
der Wurf	the litter
die Marine	the marine
der Groll	the resentment
der CoOp	the coop
der Zigeuner	the gypsy
die Nachahmung	the imitation
die Flöte	the flute
der Grieche	the greek
die Wohnung	the condo
der Zeigefinger	the forefinger
das Begräbnis	the burial
der Smaragd	the emerald
der Bademantel	the bathrobe
das Scharnier	the hinge
die Bäckerei	the bakery
das Schnäppchen	the bargain
das Sprichwort	the saying
der Vorarbeiter	the foreman
der Schwan	the swan
die Flanell	the flannel
der Käfer	the beetle
die Lern	the learning
das Lokal	the pub
die Fraktion	the fraction
die Forelle	the trout
die Kruste	the crust
die Überzugs	the overcoat
das Glitzern	the glint
das Willkommen	the welcome
das Wörterbuch	the dictionary
die Haupt	the main
der Anstieg	the climb
die Leine	the leash
